Date;Tipo;Volume;Price;SL;TP;Saldo;Price Vol;Scaled Price Return;Retorno;Dummy
2018.01.02 16:57:00;sell;19;78310;77440;80340;1002206;0,0001;-0,028285311;2206;1
2018.01.02 17:00:01;sell;19;78310;77440;80340;1004412;0,0000;-0,032808644;2206;1
2018.01.04 16:57:00;sell;19;79045;78730;81630;1004499;0,0094;0,454192378;87;1
2018.01.04 17:00:01;sell;19;79160;78730;81630;1005023;0,0015;0,042680273;524;1
2018.01.08 11:34:21;buy;38;79400;79390;76490;1002747;0,0030;0,124504574;-2276;0
2018.01.08 16:57:00;sell;19;79765;79275;82175;1003499;0,0046;0,205715376;752;1
2018.01.08 17:00:01;sell;19;79760;79275;82175;1004232;-0,0001;-0,036061144;733;1
2018.01.10 16:57:00;sell;19;78840;78525;81425;1004319;-0,0115;-0,631306279;87;1
2018.01.10 17:00:01;sell;19;78840;78525;81425;1004406;0,0000;-0,032808644;87;1
2018.01.12 16:57:00;buy;19;79465;79820;76920;1004675;0,0079;0,378523983;269;1
2018.01.12 17:00:01;buy;19;79475;79820;76920;1004906;0,0001;-0,026279084;231;1
2018.01.16 16:57:00;sell;19;80425;79955;82855;1005582;0,0120;0,587421437;676;1
2018.01.16 17:00:01;sell;19;80435;79955;82855;1006296;0,0001;-0,026357025;714;1
2018.01.18 12:36:43;buy;38;81655;81645;78745;1004020;0,0152;0,754190974;-2276;0
2018.01.19 15:50:29;buy;38;81540;81535;78635;1001782;-0,0014;-0,105884651;-2238;0
2018.01.22 13:27:32;buy;38;81595;81590;78690;999564;0,0007;0,002190042;-2218;0
2018.01.22 16:57:00;sell;19;81725;81430;84330;999585;0,0016;0,049859762;21;1
2018.01.22 17:00:01;sell;19;81765;81430;84330;999758;0,0005;-0,007412673;173;1
2018.01.24 16:57:00;sell;19;83665;81645;84545;1006324;0,0232;1,172909834;6566;1
2018.01.24 17:00:01;sell;19;83570;81645;84545;1012529;-0,0011;-0,091725497;6205;1
2018.01.30 16:57:00;buy;19;84280;84555;81655;1012504;0,0085;0,408017866;-25;0
2018.01.30 17:00:01;buy;19;84380;84555;81655;1012099;0,0012;0,028756547;-405;0
2018.02.01 16:57:00;sell;19;85905;85820;88720;1011342;0,0181;0,904947848;-757;0
2018.02.01 17:00:01;sell;19;85870;85820;88720;1010452;-0,0004;-0,053948857;-890;0
2018.02.08 16:57:00;buy;19;81815;83160;80260;1014463;-0,0472;-2,483051617;4011;1
2018.02.08 17:00:01;buy;19;81820;83160;80260;1018455;0,0001;-0,029637639;3992;1
2018.02.16 16:57:00;sell;19;85070;84710;87610;1018713;0,0397;2,028218173;258;1
2018.02.16 17:00:01;sell;19;85150;84710;87610;1019275;0,0009;0,01598613;562;1
2018.02.20 16:57:00;sell;19;86670;85600;88500;1022241;0,0179;0,893421034;2966;1
2018.02.20 17:00:01;sell;19;86675;85600;88500;1025226;0,0001;-0,02981527;2985;1
2018.02.22 15:21:19;sell;38;87360;87360;90260;1023006;0,0079;0,377259921;-2220;0
2018.02.23 14:40:16;buy;38;87620;88015;85115;1023808;0,0030;0,121617377;802;1
2018.02.26 16:57:00;buy;19;88350;88760;85860;1024276;0,0083;0,399485516;468;1
2018.02.26 17:00:01;buy;19;88430;88760;85860;1024440;0,0009;0,014174621;164;1
2018.02.28 11:41:32;sell;38;87515;87520;90420;1022182;-0,0103;-0,569693588;-2258;0
2018.02.28 16:57:00;buy;19;86825;87125;84225;1022232;-0,0079;-0,441905696;50;1
2018.02.28 17:00:01;buy;19;86845;87125;84225;1022206;0,0002;-0,020856523;-26;0
2018.03.05 16:57:00;sell;19;86590;86065;88965;1023101;-0,0029;-0,185163084;895;1
2018.03.05 17:00:01;sell;19;86625;86065;88965;1024129;0,0004;-0,011835667;1028;1
2018.03.07 11:04:19;sell;38;85955;85955;88855;1021909;-0,0077;-0,434129113;-2220;0
2018.03.08 16:45:16;buy;38;85560;85545;82645;1019595;-0,0046;-0,271252264;-2314;0
2018.03.09 16:57:00;sell;19;86695;86310;89210;1019958;0,0133;0,655502566;363;1
2018.03.09 17:00:01;sell;19;86730;86310;89210;1020454;0,0004;-0,011861069;496;1
2018.03.13 16:57:00;buy;19;86830;87525;84625;1021995;0,0012;0,027017418;1541;1
2018.03.13 17:00:01;buy;19;86890;87525;84625;1023308;0,0007;0,003045653;1313;1
2018.03.15 10:38:43;sell;38;86090;86090;88990;1021088;-0,0092;-0,510535819;-2220;0
2018.03.15 12:55:17;sell;38;85695;85695;88595;1018888;-0,0046;-0,270878354;-2200;0
2018.03.15 16:57:00;buy;19;85490;85985;83085;1019669;-0,0024;-0,156933322;781;1
2018.03.15 17:00:01;buy;19;85475;85985;83085;1020507;-0,0002;-0,041912716;838;1
2018.03.20 16:57:00;sell;19;84535;84200;87100;1020670;-0,0110;-0,603430629;163;1
2018.03.20 17:00:01;sell;19;84565;84200;87100;1020947;0,0004;-0,0143948;277;1
2018.03.22 16:26:43;sell;38;84900;84910;87810;1018651;0,0040;0,172739667;-2296;0
2018.03.23 13:06:41;sell;38;84485;84490;87390;1016413;-0,0049;-0,286438376;-2238;0
2018.03.23 16:46:10;sell;38;84950;84950;87850;1014213;0,0055;0,252774849;-2200;0
2018.03.26 16:32:32;buy;38;85470;85865;82965;1015035;0,0061;0,284805415;822;1
2018.03.27 16:57:00;buy;19;83940;85505;82605;1019882;-0,0179;-0,961641316;4847;1
2018.03.27 17:00:01;buy;19;83930;85505;82605;1024767;-0,0001;-0,0389901;4885;1
2018.04.03 10:39:14;buy;38;85605;85600;82700;1022549;0,0200;1,002708623;-2218;0
2018.04.03 11:44:43;buy;38;85395;85375;82475;1020197;-0,0025;-0,160094433;-2352;0
2018.04.03 16:07:43;buy;38;84870;84855;81955;1017883;-0,0061;-0,351805657;-2314;0
2018.04.09 16:57:00;buy;19;83340;85235;82335;1023994;-0,0180;-0,968207825;6111;1
2018.04.09 17:00:01;buy;19;83315;85235;82335;1030200;-0,0003;-0,048373541;6206;1
2018.04.11 16:57:00;sell;19;85205;84490;87390;1031817;0,0227;1,144250709;1617;1
2018.04.11 17:00:01;sell;19;85240;84490;87390;1033567;0,0004;-0,011494754;1750;1
2018.04.13 14:20:29;buy;38;84585;84580;81680;1031329;-0,0077;-0,431519091;-2238;0
2018.04.13 16:57:00;buy;19;84290;84630;81730;1031521;-0,0035;-0,213771073;192;1
2018.04.13 17:00:01;buy;19;84270;84630;81730;1031789;-0,0002;-0,045120221;268;1
2018.04.17 16:57:00;sell;19;84030;83575;86475;1032408;-0,0028;-0,180582635;619;1
2018.04.17 17:00:01;sell;19;84075;83575;86475;1033198;0,0005;-0,005021884;790;1
2018.04.20 16:57:00;sell;19;86210;85775;88675;1033741;0,0254;1,284813122;543;1
2018.04.20 17:00:01;sell;19;86235;85775;88675;1034379;0,0003;-0,017761914;638;1
2018.04.24 11:18:32;sell;38;86910;86910;89810;1032179;0,0078;0,373335282;-2200;0
2018.04.24 13:57:32;sell;38;86455;86455;89355;1030039;-0,0052;-0,304453448;-2140;0
2018.04.24 16:57:00;buy;19;86070;86280;83380;1029737;-0,0045;-0,263871624;-302;0
2018.04.24 17:00:01;buy;19;86020;86280;83380;1029625;-0,0006;-0,062951053;-112;0
2018.04.26 16:57:00;sell;19;87030;86425;89325;1030814;0,0117;0,576421934;1189;1
2018.04.26 17:00:01;sell;19;87050;86425;89325;1032079;0,0002;-0,020884676;1265;1
2018.05.02 15:15:10;buy;38;85670;85645;82745;1029689;-0,0159;-0,855373343;-2390;0
2018.05.07 12:37:40;sell;38;83790;83790;86690;1027489;-0,0219;-1,171454943;-2200;0
2018.05.07 16:01:39;sell;38;83525;83525;86425;1025309;-0,0032;-0,19691048;-2180;0
2018.05.08 13:55:43;sell;38;83125;83125;86025;1023149;-0,0048;-0,28129541;-2160;0
2018.05.08 15:40:43;sell;38;83455;83455;86355;1020929;0,0040;0,173179412;-2220;0
2018.05.09 11:13:21;buy;38;83760;83755;80855;1018731;0,0037;0,156821439;-2198;0
2018.05.09 16:57:00;sell;19;84835;83675;86575;1022029;0,0128;0,633125914;3298;1
2018.05.09 17:00:01;sell;19;84825;83675;86575;1025289;-0,0001;-0,038924886;3260;1
2018.05.14 16:57:00;buy;19;85615;86230;83330;1026526;0,0093;0,450431472;1237;1
2018.05.14 17:00:01;buy;19;85675;86230;83330;1027535;0,0007;0,003554477;1009;1
2018.05.16 16:57:00;sell;9;86835;85870;88770;1028732;0,0135;0,669719348;1197;1
2018.05.16 17:00:01;sell;9;86800;85870;88770;1029866;-0,0004;-0,053722446;1134;1
2018.05.22 10:30:29;buy;38;82420;82415;79515;1027628;-0,0505;-2,65107691;-2238;0
2018.05.22 11:35:05;buy;38;82155;82150;79250;1025410;-0,0032;-0,19963821;-2218;0
2018.05.22 14:18:59;sell;38;82365;82365;85265;1023230;0,0026;0,099822359;-2180;0
2018.05.22 16:57:00;sell;19;83145;82525;85425;1024476;0,0095;0,458564772;1246;1
2018.05.22 17:00:01;sell;19;83130;82525;85425;1025665;-0,0002;-0,042169485;1189;1
2018.05.30 11:16:32;buy;38;76150;76135;73235;1023351;-0,0840;-4,389506067;-2314;0
2018.05.30 16:57:00;sell;19;76675;76205;79105;1024057;0,0069;0,324916241;706;1
2018.05.30 17:00:01;sell;19;76815;76205;79105;1025295;0,0018;0,061931493;1238;1
2018.06.05 16:57:00;buy;19;76590;77550;74650;1027843;-0,0029;-0,184792073;2548;1
2018.06.05 17:00:01;buy;19;76565;77550;74650;1030486;-0,0003;-0,049745301;2643;1
2018.06.11 14:32:32;sell;38;72365;72365;75265;1028266;-0,0549;-2,879096109;-2220;0
2018.06.11 16:00:05;buy;38;72300;72295;69395;1026048;-0,0009;-0,079414935;-2218;0
2018.06.12 14:42:43;sell;38;72465;72475;75375;1023752;0,0023;0,085605998;-2296;0
2018.06.12 16:10:43;buy;38;72580;72575;69675;1021514;0,0016;0,049534852;-2238;0
2018.06.13 12:39:41;buy;38;73225;73210;70310;1019240;0,0089;0,428299198;-2274;0
2018.06.13 16:01:09;buy;38;72745;73140;70240;1020122;-0,0066;-0,372936039;882;1
2018.06.14 10:41:41;buy;38;72990;72980;70080;1017846;0,0034;0,141943573;-2276;0
2018.06.14 16:57:00;buy;19;72040;73005;70105;1020413;-0,0130;-0,708144795;2567;1
2018.06.14 17:00:01;buy;19;72115;73005;70105;1022695;0,0010;0,021210453;2282;1
2018.06.19 15:25:10;sell;19;72660;69840;72740;1032311;0,0076;0,359321882;9616;1
2018.06.19 15:25:21;sell;19;72760;69840;72740;1042307;0,0014;0,038602233;9996;1
2018.06.21 16:57:00;buy;9;70595;71650;68750;1043666;-0,0298;-1,576729262;1359;1
2018.06.21 17:00:01;buy;9;70520;71650;68750;1045160;-0,0011;-0,08793345;1494;1
2018.06.25 14:10:03;buy;38;71190;71185;68285;1042922;0,0095;0,46016336;-2238;0
2018.06.26 12:40:29;buy;38;71105;71100;68200;1040744;-0,0012;-0,094761265;-2178;0
2018.06.26 14:14:16;sell;38;71085;71085;73985;1038564;-0,0003;-0,047403157;-2180;0
2018.06.26 16:57:00;sell;19;71705;71210;74110;1039345;0,0087;0,419748556;781;1
2018.06.26 17:00:01;sell;19;71740;71210;74110;1040259;0,0005;-0,007481958;914;1
2018.06.28 16:57:00;sell;19;72100;71365;74265;1041952;0,0050;0,227567317;1693;1
2018.06.28 17:00:01;sell;19;72180;71365;74265;1043949;0,0011;0,024763776;1997;1
2018.07.02 14:10:32;sell;38;72650;72655;75555;1041711;0,0065;0,305054437;-2238;0
2018.07.02 16:57:00;sell;19;73255;72520;75420;1043394;0,0083;0,399286627;1683;1
2018.07.02 17:00:01;sell;19;73260;72520;75420;1045096;0,0001;-0,029267101;1702;1
2018.07.04 16:57:00;sell;19;75105;74040;76940;1048033;0,0252;1,27393144;2937;1
2018.07.04 17:00:01;sell;19;75150;74040;76940;1051141;0,0006;-0,001719882;3108;1
2018.07.06 16:57:00;sell;19;75360;75010;77910;1051371;0,0028;0,112185368;230;1
2018.07.06 17:00:01;sell;19;75435;75010;77910;1051886;0,0010;0,018830631;515;1
2018.07.11 15:08:42;sell;38;74610;74610;77510;1049726;-0,0109;-0,600275904;-2160;0
2018.07.12 16:57:00;sell;19;76210;75310;78210;1052036;0,0214;1,079903171;2310;1
2018.07.12 17:00:01;sell;19;76135;75310;78210;1054061;-0,0010;-0,083871965;2025;1
2018.07.16 11:15:10;sell;38;76855;76860;79760;1051823;0,0095;0,45788214;-2238;0
2018.07.16 16:57:00;sell;19;76885;76495;79395;1052195;0,0004;-0,012554733;372;1
2018.07.16 17:00:01;sell;19;76875;76495;79395;1052529;-0,0001;-0,039557313;334;1
2018.07.24 11:40:32;buy;38;79370;79365;76465;1050291;0,0325;1,651203341;-2238;0
2018.07.24 16:57:00;sell;19;79510;79080;81980;1050815;0,0018;0,058714602;524;1
2018.07.24 17:00:01;sell;19;79480;79080;81980;1051225;-0,0004;-0,052386235;410;1
2018.07.26 16:57:00;buy;19;79610;80625;77725;1053982;0,0016;0,052059607;2757;1
2018.07.26 17:00:01;buy;19;79475;80625;77725;1057252;-0,0017;-0,120797141;3270;1
2018.07.30 16:57:00;sell;19;80495;79980;82880;1058099;0,0128;0,633122601;847;1
2018.07.30 17:00:01;sell;19;80460;79980;82880;1058813;-0,0004;-0,055369672;714;1
2018.08.01 13:07:05;sell;38;79075;79075;81975;1056593;-0,0172;-0,925969131;-2220;0
2018.08.02 16:57:00;sell;19;79820;79050;81950;1058409;0,0094;0,456042718;1816;1
2018.08.02 17:00:01;sell;19;79780;79050;81950;1060073;-0,0005;-0,05881072;1664;1
2018.08.07 16:57:00;buy;19;80330;81485;78585;1063362;0,0069;0,32489916;3289;1
2018.08.07 17:00:01;buy;19;80290;81485;78585;1066803;-0,0005;-0,058645637;3441;1
2018.08.15 16:57:00;buy;19;77830;78245;75345;1067280;-0,0306;-1,622575381;477;1
2018.08.15 17:00:01;buy;19;77790;78245;75345;1067909;-0,0005;-0,059475555;629;1
2018.08.17 14:32:42;buy;38;76565;76560;73660;1065711;-0,0157;-0,849902742;-2198;0
2018.08.17 16:57:00;sell;19;76630;76450;79350;1065315;0,0008;0,011241043;-396;0
2018.08.17 17:00:01;sell;19;76655;76450;79350;1065014;0,0003;-0,015880827;-301;0
2018.08.21 15:40:43;sell;38;76210;76210;79110;1062794;-0,0058;-0,334025506;-2220;0
2018.08.22 16:57:00;sell;19;77445;75755;78655;1068116;0,0162;0,808034046;5322;1
2018.08.22 17:00:01;sell;19;77385;75755;78655;1073210;-0,0008;-0,073007863;5094;1
2018.08.24 15:53:07;buy;38;76765;76760;73860;1070992;-0,0080;-0,448522652;-2218;0
2018.08.27 16:57:00;sell;19;78275;77440;80340;1073075;0,0197;0,987833389;2083;1
2018.08.27 17:00:01;sell;19;78405;77440;80340;1075652;0,0017;0,053366107;2577;1
2018.08.29 16:57:00;sell;19;79015;78095;80995;1078058;0,0078;0,37087935;2406;1
2018.08.29 17:00:01;sell;19;78935;78095;80995;1080160;-0,0010;-0,085342611;2102;1
2018.09.04 16:57:00;buy;19;75160;75905;73005;1081891;-0,0478;-2,514267618;1731;1
2018.09.04 17:00:01;buy;19;75025;75905;73005;1084135;-0,0018;-0,126006678;2244;1
2018.09.06 12:28:42;buy;38;75715;75710;72810;1081917;0,0092;0,444394003;-2218;0
2018.09.06 16:57:00;sell;19;76710;75555;78455;1085196;0,0131;0,649060301;3279;1
2018.09.06 17:00:01;sell;19;76715;75555;78455;1088494;0,0001;-0,029426611;3298;1
2018.09.13 15:34:16;sell;38;74880;74890;77790;1086198;-0,0239;-1,273933679;-2296;0
2018.09.14 12:33:26;buy;38;75625;75620;72720;1083980;0,0099;0,483429623;-2218;0
2018.09.14 14:33:05;buy;38;75495;75485;72585;1081704;-0,0017;-0,122003071;-2276;0
2018.09.14 16:57:00;sell;19;75695;75250;78150;1082285;0,0026;0,104649845;581;1
2018.09.14 17:00:01;sell;19;75685;75250;78150;1082828;-0,0001;-0,039663408;543;1
2018.09.20 16:57:00;sell;19;78480;78130;81030;1083048;0,0369;1,883351285;220;1
2018.09.20 17:00:01;sell;19;78425;78130;81030;1083059;-0,0007;-0,069171957;11;1
2018.09.24 16:57:00;buy;19;78190;78880;75980;1084601;-0,0030;-0,188288128;1542;1
2018.09.24 17:00:01;buy;19;78145;78880;75980;1086314;-0,0006;-0,062670793;1713;1
2018.09.26 15:00:16;buy;38;79355;79350;76450;1084076;0,0155;0,770613748;-2238;0
2018.09.27 16:57:00;sell;19;80095;79335;82235;1085854;0,0093;0,451048526;1778;1
2018.09.27 17:00:01;sell;19;80090;79335;82235;1087613;-0,0001;-0,036047744;1759;1
2018.10.01 13:38:32;buy;38;78845;78830;75930;1085299;-0,0155;-0,839394894;-2314;0
2018.10.01 14:40:29;sell;38;78770;78780;81680;1083003;-0,0010;-0,082165429;-2296;0
2018.10.01 15:29:32;buy;38;78765;78760;75860;1080765;-0,0001;-0,036102229;-2238;0
2018.10.10 16:57:00;buy;19;83840;84525;81625;1082298;0,0644;3,310392649;1533;1
2018.10.10 17:00:01;buy;19;83885;84525;81625;1083660;0,0005;-0,004958913;1362;1
2018.10.15 12:40:32;sell;38;83800;83800;86700;1081500;-0,0010;-0,085385471;-2160;0
2018.10.15 15:34:30;sell;38;83815;83815;86715;1079300;0,0002;-0,023520969;-2200;0
2018.10.16 16:57:00;sell;19;85620;84235;87135;1083473;0,0215;1,0846082;4173;1
2018.10.16 17:00:01;sell;19;85680;84235;87135;1087874;0,0007;0,003552354;4401;1
2018.10.22 11:42:21;buy;38;86160;86140;83240;1085522;0,0056;0,25787563;-2352;0
2018.10.23 16:57:00;sell;19;86055;85150;88050;1087851;-0,0012;-0,096041582;2329;1
2018.10.23 17:00:01;sell;19;85995;85150;88050;1089952;-0,0007;-0,068985839;2101;1
2018.10.26 12:08:14;buy;38;84510;84500;81600;1087716;-0,0173;-0,928818959;-2236;0
2018.10.26 16:11:16;sell;38;85355;84955;87855;1088536;0,0100;0,486001387;820;1
2018.11.06 14:34:08;sell;38;89415;89415;92315;1086376;0,0476;2,435257666;-2160;0
2018.11.07 16:57:00;buy;19;88280;90035;87135;1091965;-0,0127;-0,691444299;5589;1
2018.11.07 17:00:01;buy;19;88320;90035;87135;1097402;0,0005;-0,009298384;5437;1
2018.11.12 14:41:19;buy;38;85870;85865;82965;1095164;-0,0277;-1,472159865;-2238;0
2018.11.12 16:57:00;sell;9;86110;85710;88610;1095344;0,0028;0,112211902;180;1
2018.11.12 17:00:01;sell;9;86050;85710;88610;1095416;-0,0007;-0,068962732;72;1
2018.11.14 10:50:10;buy;38;85155;85150;82250;1093178;-0,0104;-0,572483168;-2238;0
2018.11.14 13:52:23;sell;38;85220;85220;88120;1090958;0,0008;0,006797537;-2220;0
2018.11.14 14:57:14;buy;38;85265;85255;82355;1088702;0,0005;-0,005409894;-2256;0
2018.11.14 16:28:00;sell;38;85585;85585;88485;1086482;0,0038;0,16192408;-2220;0
2018.11.21 12:41:43;sell;38;87040;87040;89940;1084282;0,0170;0,849306129;-2200;0
2018.11.22 16:57:00;buy;19;87810;87945;85045;1083695;0,0088;0,426211347;-587;0
2018.11.22 17:00:01;buy;19;87740;87945;85045;1083374;-0,0008;-0,074171814;-321;0
2018.11.26 16:57:00;buy;9;85595;87095;84195;1085534;-0,0244;-1,301305582;2160;1
2018.11.26 17:00:01;buy;9;85610;87095;84195;1087667;0,0002;-0,023715739;2133;1
2018.11.30 16:57:00;sell;19;90260;89920;92820;1087849;0,0543;2,785497794;182;1
2018.11.30 17:00:01;sell;19;90260;89920;92820;1088031;0,0000;-0,032808644;182;1
2018.12.04 16:57:00;buy;9;88510;90150;87250;1090443;-0,0194;-1,038819057;2412;1
2018.12.04 17:00:01;buy;9;88440;90150;87250;1092981;-0,0008;-0,073844685;2538;1
2018.12.06 11:40:29;sell;38;88150;88150;91050;1090761;-0,0033;-0,202949659;-2220;0
2018.12.06 13:26:43;buy;38;87965;87945;85045;1088409;-0,0021;-0,141703952;-2352;0
2018.12.06 15:15:16;buy;38;87690;87670;84770;1086097;-0,0031;-0,195020481;-2312;0
2018.12.07 10:49:16;buy;38;88635;88630;85730;1083859;0,0108;0,526358308;-2238;0
2018.12.07 14:13:43;sell;38;89400;89000;91900;1084679;0,0086;0,415024202;820;1
2018.12.14 16:57:00;sell;19;88265;88165;91065;1083949;-0,0127;-0,691554808;-730;0
2018.12.14 17:00:01;sell;19;88310;88165;91065;1083390;0,0005;-0,006355107;-559;0
2018.12.18 16:57:00;sell;19;87865;87640;90540;1083135;-0,0050;-0,294271429;-255;0
2018.12.18 17:00:01;sell;19;87835;87640;90540;1082766;-0,0003;-0,05052462;-369;0
2018.12.27 12:47:16;sell;38;85820;85845;88745;1080356;-0,0229;-1,223138157;-2410;0
2018.12.27 15:23:19;sell;38;85965;85965;88865;1078136;0,0017;0,054858983;-2220;0
2019.01.04 13:20:08;sell;38;91970;91970;94870;1075916;0,0699;3,591716368;-2220;0
2019.01.04 14:16:17;sell;38;92995;93000;95900;1073658;0,0111;0,545470376;-2258;0
2019.01.07 15:10:32;sell;38;92115;92115;95015;1071438;-0,0095;-0,523810156;-2220;0
2019.01.08 16:57:00;buy;19;92420;92650;89750;1071212;0,0033;0,138993762;-226;0
2019.01.08 17:00:01;buy;19;92330;92650;89750;1071328;-0,0010;-0,083337131;116;1
2019.01.11 14:50:42;buy;38;94265;94260;91360;1069110;0,0210;1,054612794;-2218;0
2019.01.14 16:57:00;sell;19;94875;94350;97250;1069995;0,0065;0,302959214;885;1
2019.01.14 17:00:01;sell;19;94870;94350;97250;1070861;-0,0001;-0,035543144;866;1
2019.01.16 16:57:00;sell;19;94480;94235;97135;1070682;-0,0041;-0,246110907;-179;0
2019.01.16 17:00:01;sell;19;94465;94235;97135;1070446;-0,0002;-0,041046441;-236;0
2019.01.18 16:57:00;sell;19;96570;96015;98915;1071445;0,0223;1,123412556;999;1
2019.01.18 17:00:01;sell;19;96655;96015;98915;1072767;0,0009;0,012861928;1322;1
2019.01.22 13:14:01;sell;38;95795;95795;98695;1070547;-0,0089;-0,494481013;-2220;0
2019.01.22 14:59:10;sell;38;95345;95360;98260;1068213;-0,0047;-0,276550115;-2334;0
2019.01.23 16:57:00;sell;19;96400;95890;98790;1069041;0,0111;0,541326714;828;1
2019.01.23 17:00:01;sell;19;96420;95890;98790;1069945;0,0002;-0,022043676;904;1
2019.01.28 14:13:43;buy;18;95730;96115;93215;1070251;-0,0072;-0,404122982;306;1
2019.01.30 16:57:00;buy;19;96285;96735;93835;1070861;0,0058;0,268009953;610;1
2019.01.30 17:00:01;buy;19;96320;96735;93835;1071338;0,0004;-0,01394745;477;1
2019.02.04 12:47:21;buy;38;97500;97490;94590;1069102;0,0123;0,602851952;-2236;0
2019.02.04 16:57:00;sell;9;98460;97880;100780;1069606;0,0098;0,478080147;504;1
2019.02.04 17:00:01;sell;9;98535;97880;100780;1070245;0,0008;0,006715384;639;1
2019.02.06 16:57:00;buy;19;95455;97435;94535;1076669;-0,0313;-1,654693252;6424;1
2019.02.06 17:00:01;buy;19;95545;97435;94535;1082751;0,0009;0,016113287;6082;1
2019.02.11 12:32:01;sell;38;94940;94945;97845;1080493;-0,0063;-0,361362952;-2258;0
2019.02.11 15:52:14;buy;38;94535;94515;91615;1078161;-0,0043;-0,254151522;-2332;0
2019.02.12 16:57:00;sell;19;96260;95315;98215;1080652;0,0182;0,913986949;2491;1
2019.02.12 17:00:01;sell;19;96135;95315;98215;1082668;-0,0013;-0,100187543;2016;1
2019.02.14 12:18:43;buy;38;96125;96110;93210;1080394;-0,0001;-0,038205964;-2274;0
2019.02.14 16:57:00;sell;19;97130;95735;98635;1084585;0,0105;0,509678519;4191;1
2019.02.14 17:00:01;sell;19;97195;95735;98635;1089023;0,0007;0,001914555;4438;1
2019.02.18 16:36:08;sell;38;97280;97280;100180;1086803;0,0009;0,01256825;-2220;0
2019.02.19 15:05:16;sell;38;98690;98690;101590;1084583;0,0145;0,719256235;-2220;0
2019.02.20 12:26:43;buy;38;98890;99285;96385;1085405;0,0020;0,07234313;822;1
2019.02.20 12:48:05;sell;38;98590;98590;101490;1083185;-0,0030;-0,190217308;-2220;0
2019.02.21 13:00:21;buy;38;97235;97225;94325;1080929;-0,0137;-0,745934503;-2256;0
2019.02.21 15:24:43;buy;38;97205;97195;94295;1078653;-0,0003;-0,048817429;-2276;0
2019.02.22 11:46:21;buy;38;98215;98210;95310;1076435;0,0104;0,506320149;-2218;0
2019.02.22 16:57:00;sell;19;98270;97970;100870;1076465;0,0006;-0,003752055;30;1
2019.02.22 17:00:01;sell;19;98220;97970;100870;1076305;-0,0005;-0,05920894;-160;0
2019.02.26 12:40:15;buy;38;98520;98515;95615;1074067;0,0031;0,125673772;-2238;0
2019.02.26 16:57:00;buy;19;98495;98665;95765;1073613;-0,0003;-0,045975296;-454;0
2019.02.26 17:00:01;buy;19;98470;98665;95765;1073254;-0,0003;-0,045978638;-359;0
2019.02.28 16:57:00;buy;19;96310;97980;95080;1078530;-0,0219;-1,170985027;5276;1
2019.02.28 17:00:01;buy;19;96195;97980;95080;1084243;-0,0012;-0,094765049;5713;1
2019.03.07 15:56:21;sell;38;94525;94525;97425;1082023;-0,0174;-0,933599002;-2220;0
2019.03.08 16:57:00;sell;19;95620;94350;97250;1085739;0,0116;0,568264315;3716;1
2019.03.08 17:00:01;sell;19;95685;94350;97250;1089702;0,0007;0,002462893;3963;1
2019.03.13 16:57:00;sell;19;99400;98050;100950;1093722;0,0388;1,981725877;4020;1
2019.03.13 17:00:01;sell;19;99445;98050;100950;1097913;0,0005;-0,009318488;4191;1
2019.03.15 16:57:00;sell;19;99410;99070;101970;1098125;-0,0004;-0,051070497;212;1
2019.03.15 17:00:01;sell;19;99450;99070;101970;1098489;0,0004;-0,011930606;364;1
2019.03.19 11:34:10;buy;38;100230;100225;97325;1096291;0,0078;0,374149339;-2198;0
2019.03.19 16:35:20;sell;38;100150;100150;103050;1094071;-0,0008;-0,074223105;-2220;0
2019.03.20 16:17:05;sell;38;99320;98920;101820;1094891;-0,0083;-0,462826902;820;1
2019.03.26 15:31:14;sell;38;95075;95085;97985;1092595;-0,0427;-2,250498145;-2296;0
2019.04.02 15:30:14;buy;38;95640;96035;93135;1093457;0,0059;0,275539878;862;1
2019.04.02 15:53:14;sell;38;95315;95340;98240;1091047;-0,0034;-0,209129445;-2410;0
2019.04.03 14:43:08;sell;38;96075;96075;98975;1088827;0,0080;0,380916673;-2220;0
2019.04.03 16:57:00;buy;9;94665;96035;93135;1090753;-0,0147;-0,794306134;1926;1
2019.04.03 17:00:01;buy;9;94670;96035;93135;1092670;0,0001;-0,030068077;1917;1
2019.04.05 16:57:00;sell;19;97200;96870;99770;1092824;0,0267;1,353844692;154;1
2019.04.05 17:00:01;sell;19;97240;96870;99770;1093130;0,0004;-0,01145591;306;1
2019.04.09 12:08:21;sell;38;96270;96275;99175;1090912;-0,0100;-0,550399435;-2218;0
2019.04.09 15:28:02;buy;38;96215;96210;93310;1088674;-0,0006;-0,06245228;-2238;0
2019.04.10 16:57:00;buy;19;95955;96730;93830;1090539;-0,0027;-0,173022302;1865;1
2019.04.10 17:00:01;buy;19;96005;96730;93830;1092214;0,0005;-0,005771416;1675;1
2019.04.16 16:57:00;sell;19;94320;93045;95945;1095949;-0,0176;-0,943488667;3735;1
2019.04.16 17:00:01;sell;19;94240;93045;95945;1099380;-0,0008;-0,076818095;3431;1
2019.04.18 16:57:00;sell;9;95210;94315;97215;1100451;0,0103;0,501258934;1071;1
2019.04.18 17:00:01;sell;9;95205;94315;97215;1101513;-0,0001;-0,035533522;1062;1
2019.04.23 16:57:00;sell;19;96515;96055;98955;1102161;0,0138;0,681147105;648;1
2019.04.23 17:00:01;sell;19;96605;96055;98955;1103151;0,0009;0,015575989;990;1
2019.04.29 13:52:15;buy;38;97150;97145;94245;1100953;0,0056;0,259914226;-2198;0
2019.04.29 16:40:16;buy;38;97075;97070;94170;1098715;-0,0008;-0,072865625;-2238;0
2019.04.30 16:55:32;buy;38;97170;97165;94265;1096477;0,0010;0,0179694;-2238;0
2019.05.02 11:25:21;sell;38;96165;96165;99065;1094257;-0,0103;-0,569461711;-2220;0
2019.05.02 14:12:21;buy;38;96305;96300;93400;1092059;0,0015;0,042730274;-2198;0
2019.05.02 16:57:00;buy;19;96210;96500;93600;1092061;-0,0010;-0,083992679;2;1
2019.05.02 17:00:01;buy;19;96170;96500;93600;1092215;-0,0004;-0,054381097;154;1
2019.05.06 16:57:00;sell;19;95530;95250;98150;1092169;-0,0067;-0,378111455;-46;0
2019.05.06 17:00:01;sell;19;95535;95250;98150;1092142;0,0001;-0,030092892;-27;0
2019.05.08 16:57:00;sell;19;96220;96015;98915;1091811;0,0072;0,339229801;-331;0
2019.05.08 17:00:01;sell;19;96215;96015;98915;1091461;-0,0001;-0,03550492;-350;0
2019.05.15 11:36:02;sell;38;91280;91290;94190;1089225;-0,0513;-2,694171734;-2236;0
2019.05.15 14:51:16;buy;38;91925;91920;89020;1087007;0,0071;0,33383473;-2218;0
2019.05.15 16:57:00;buy;19;91570;92130;89230;1088065;-0,0039;-0,233188689;1058;1
2019.05.15 17:00:01;buy;19;91580;92130;89230;1089085;0,0001;-0,027142253;1020;1
2019.05.17 14:58:16;sell;38;90655;90265;93165;1089829;-0,0101;-0,556892582;744;1
2019.05.17 16:57:00;buy;9;90165;90885;87985;1090585;-0,0054;-0,313264217;756;1
2019.05.17 17:00:01;buy;9;90165;90885;87985;1091341;0,0000;-0,032808644;756;1
2019.05.23 16:57:00;buy;19;94150;94715;91815;1092418;0,0442;2,260434457;1077;1
2019.05.23 17:00:01;buy;19;94215;94715;91815;1093248;0,0007;0,003013601;830;1
2019.05.27 15:37:42;sell;38;94975;94575;97475;1094068;0,0081;0,385747091;820;1
2019.05.28 11:29:08;buy;38;95475;95470;92570;1091850;0,0053;0,240353467;-2218;0
2019.05.28 16:57:00;sell;9;96415;95795;98695;1092426;0,0098;0,478046703;576;1
2019.05.28 17:00:01;sell;9;96380;95795;98695;1092939;-0,0004;-0,051644406;513;1
2019.05.30 16:57:00;sell;9;97765;96820;99720;1094100;0,0144;0,712820043;1161;1
2019.05.30 17:00:01;sell;9;97765;96820;99720;1095261;0,0000;-0,032808644;1161;1
2019.06.03 11:50:21;sell;38;97215;97230;100130;1092927;-0,0056;-0,324711968;-2334;0
2019.06.03 14:26:09;buy;38;97520;97510;94610;1090671;0,0031;0,129980829;-2256;0
2019.06.03 16:57:00;buy;19;97005;97430;94530;1091206;-0,0053;-0,306822985;535;1
2019.06.03 17:00:01;buy;19;96990;97430;94530;1091798;-0,0002;-0,040832015;592;1
2019.06.05 16:57:00;buy;19;96145;97375;94475;1095392;-0,0087;-0,4848618;3594;1
2019.06.05 17:00:01;buy;19;96095;97375;94475;1099176;-0,0005;-0,05979244;3784;1
2019.06.07 10:40:10;buy;38;97615;97610;94710;1096998;0,0158;0,787925599;-2178;0
2019.06.07 13:36:32;sell;38;98020;98020;100920;1094778;0,0041;0,182468648;-2220;0
2019.06.10 14:16:43;sell;38;97070;97080;99980;1092482;-0,0097;-0,535693623;-2296;0
2019.06.10 16:57:00;sell;19;97525;97160;100060;1092759;0,0047;0,210403986;277;1
2019.06.10 17:00:01;sell;19;97525;97160;100060;1093036;0,0000;-0,032808644;277;1
2019.06.13 16:57:00;buy;9;99795;100185;97285;1093198;0,0233;1,174920802;162;1
2019.06.13 17:00:01;buy;9;99835;100185;97285;1093288;0,0004;-0,012011152;90;1
2019.06.17 12:33:05;sell;38;98970;98980;101880;1090992;-0,0087;-0,482374212;-2296;0
2019.06.17 14:58:16;sell;38;98860;98865;101765;1088734;-0,0011;-0,0904785;-2258;0
2019.06.18 16:57:00;sell;19;100265;99750;102650;1089581;0,0142;0,704612312;847;1
2019.06.18 17:00:01;sell;19;100285;99750;102650;1090504;0,0002;-0,022458643;923;1
2019.06.25 16:57:00;buy;19;100940;102590;99690;1095674;0,0065;0,306086291;5170;1
2019.06.25 17:00:01;buy;19;100835;102590;99690;1101243;-0,0010;-0,086782787;5569;1
2019.06.27 13:35:20;buy;38;100675;100670;97770;1099005;-0,0016;-0,1151406;-2238;0
2019.06.27 16:57:00;sell;19;101460;100560;103460;1101315;0,0078;0,371774491;2310;1
2019.06.27 17:00:01;sell;19;101455;100560;103460;1103606;0,0000;-0,035365668;2291;1
2019.07.02 13:30:09;buy;38;102110;102105;99205;1101388;0,0065;0,302178085;-2218;0
2019.07.02 16:57:00;buy;19;101320;101580;98680;1101286;-0,0077;-0,434246728;-102;0
2019.07.02 17:00:01;buy;19;101365;101580;98680;1101013;0,0004;-0,009763624;-273;0
2019.07.08 16:57:00;buy;19;105115;105350;102450;1100806;0,0370;1,886757139;-207;0
2019.07.08 17:00:01;buy;19;105080;105350;102450;1100732;-0,0003;-0,050085436;-74;0
2019.07.12 16:57:00;buy;19;104590;105890;102990;1104602;-0,0047;-0,274764296;3870;1
2019.07.12 17:00:01;buy;19;104650;105890;102990;1108244;0,0006;-0,003042618;3642;1
2019.07.16 16:57:00;buy;19;104185;104525;101625;1108446;-0,0044;-0,263363077;202;1
2019.07.16 17:00:01;buy;19;104185;104525;101625;1108648;0,0000;-0,032808644;202;1
2019.07.18 16:57:00;sell;19;105085;104230;107130;1110787;0,0086;0,415417383;2139;1
2019.07.18 17:00:01;sell;19;105080;104230;107130;1112907;0,0000;-0,035277461;2120;1
2019.07.22 16:57:00;buy;19;104225;104570;101670;1113118;-0,0081;-0,454996568;211;1
2019.07.22 17:00:01;buy;19;104285;104570;101670;1113101;0,0006;-0,002938377;-17;0
2019.07.24 15:26:21;sell;38;104300;104305;107205;1110843;0,0001;-0,025345373;-2258;0
2019.07.25 16:57:00;buy;9;102780;104760;101860;1113867;-0,0146;-0,788977935;3024;1
2019.07.25 17:00:01;buy;9;102835;104760;101860;1116792;0,0005;-0,005042611;2925;1
2019.07.29 16:57:00;sell;19;103585;102850;105750;1118485;0,0073;0,345616573;1693;1
2019.07.29 17:00:01;sell;19;103685;102850;105750;1120558;0,0010;0,017282724;2073;1
2019.07.31 10:45:14;buy;38;103095;103070;100170;1118188;-0,0057;-0,328062675;-2370;0
2019.07.31 15:00:02;buy;38;102680;102655;99755;1115818;-0,0040;-0,241675846;-2370;0
2019.08.01 14:35:05;sell;38;103230;103250;106150;1113466;0,0054;0,245122098;-2352;0
2019.08.12 11:25:10;buy;38;102005;101985;99085;1111154;-0,0119;-0,648538082;-2312;0
2019.08.19 16:57:00;buy;9;100045;101465;98565;1113170;-0,0192;-1,029806829;2016;1
2019.08.19 17:00:01;buy;9;100000;101465;98565;1115267;-0,0004;-0,056147355;2097;1
2019.08.21 10:39:04;buy;38;100740;100735;97835;1113029;0,0074;0,351156213;-2238;0
2019.08.21 16:57:00;sell;19;102090;100655;103555;1117372;0,0134;0,662522335;4343;1
2019.08.21 17:00:01;sell;19;102085;100655;103555;1121696;0,0000;-0,035349889;4324;1
2019.09.02 15:17:20;buy;38;101920;101915;99015;1119458;-0,0016;-0,11667384;-2238;0
2019.09.03 11:06:14;sell;38;101420;101435;104335;1117124;-0,0049;-0,287357029;-2334;0
2019.09.03 15:51:14;sell;38;100510;100520;103420;1114828;-0,0090;-0,498370663;-2296;0
2019.09.04 16:01:10;buy;38;101600;101580;98680;1112516;0,0108;0,529891443;-2312;0
2019.09.05 15:07:10;sell;38;103025;102645;105545;1113244;0,0140;0,694939176;728;1
2019.09.09 13:25:32;sell;38;104245;104245;107145;1111024;0,0118;0,581627796;-2220;0
2019.09.09 16:57:00;buy;19;103735;103790;100890;1110133;-0,0049;-0,286657201;-891;0
2019.09.09 17:00:01;buy;19;103760;103790;100890;1109147;0,0002;-0,02030391;-986;0
2019.09.11 10:46:03;buy;38;104200;104195;101295;1107089;0,0042;0,187221646;-2058;0
2019.09.11 12:14:16;sell;38;104195;104200;107100;1104831;0,0000;-0,03529843;-2258;0
2019.09.11 16:57:00;buy;19;104035;104310;101410;1104786;-0,0015;-0,112485623;-45;0
2019.09.11 17:00:01;buy;19;104040;104310;101410;1104722;0,0000;-0,030314909;-64;0
2019.09.13 16:57:00;buy;19;103825;105185;102285;1108810;-0,0021;-0,140034092;4088;1
2019.09.13 17:00:01;buy;19;103840;105185;102285;1112841;0,0001;-0,025312307;4031;1
2019.09.17 16:57:00;sell;19;104930;103495;106395;1117194;0,0105;0,511846457;4353;1
2019.09.17 17:00:01;sell;19;104955;103495;106395;1121642;0,0002;-0,02044632;4448;1
2019.09.19 11:10:14;sell;38;105835;105835;108735;1119442;0,0084;0,40224148;-2200;0
2019.09.19 16:57:00;buy;19;104745;105775;102875;1122256;-0,0103;-0,567196943;2814;1
2019.09.19 17:00:01;buy;19;104660;105775;102875;1125393;-0,0008;-0,074914779;3137;1
2019.09.24 16:57:00;buy;19;104075;104985;102085;1127751;-0,0056;-0,322833281;2358;1
2019.09.24 17:00:01;buy;19;104095;104985;102085;1130033;0,0002;-0,022837538;2282;1
2019.09.26 16:57:00;sell;9;105515;104695;107595;1130969;0,0136;0,675003862;936;1
2019.09.26 17:00:01;sell;9;105575;104695;107595;1132013;0,0006;-0,003303563;1044;1
2019.09.30 15:45:21;buy;38;105370;105365;102465;1129775;-0,0019;-0,133560377;-2238;0
2019.10.01 16:57:00;buy;19;104205;104680;101780;1130500;-0,0111;-0,606487313;725;1
2019.10.01 17:00:01;buy;19;104170;104680;101780;1131358;-0,0003;-0,05023631;858;1
2019.10.04 12:08:21;buy;38;101580;101575;98675;1129140;-0,0249;-1,32288928;-2218;0
2019.10.04 13:27:43;buy;38;101550;101535;98635;1126826;-0,0003;-0,048132667;-2314;0
2019.10.04 16:57:00;sell;19;102740;101780;104680;1129364;0,0117;0,575223852;2538;1
2019.10.04 17:00:01;sell;19;102635;101780;104680;1131503;-0,0010;-0,085837162;2139;1
2019.10.08 12:33:16;sell;38;101115;101120;104020;1129245;-0,0148;-0,801244919;-2258;0
2019.10.09 16:57:00;sell;19;101350;100815;103715;1130178;0,0023;0,087781561;933;1
2019.10.09 17:00:01;sell;19;101355;100815;103715;1131130;0,0000;-0,030248844;952;1
2019.10.15 16:22:16;sell;38;104630;104635;107535;1128892;0,0323;1,643777541;-2238;0
2019.10.16 10:41:08;buy;38;104845;104840;101940;1126694;0,0021;0,07381217;-2198;0
2019.10.16 13:59:32;buy;38;105095;105090;102190;1124456;0,0024;0,090914812;-2238;0
2019.10.16 16:57:00;sell;19;106240;105075;107975;1127783;0,0109;0,532496828;3327;1
2019.10.16 17:00:01;sell;19;106240;105075;107975;1131110;0,0000;-0,032808644;3327;1
2019.10.18 11:35:13;sell;38;105980;105990;108890;1128834;-0,0024;-0,159791486;-2276;0
2019.10.18 14:21:21;buy;38;105715;105705;102805;1126558;-0,0025;-0,16255098;-2276;0
2019.10.21 12:01:21;buy;38;105815;105805;102905;1124322;0,0009;0,016273457;-2236;0
2019.10.21 12:54:10;buy;38;105825;105810;102910;1122028;0,0001;-0,027905072;-2294;0
2019.10.21 16:57:00;sell;19;106665;105865;108765;1123958;0,0079;0,379052448;1930;1
2019.10.21 17:00:01;sell;19;106685;105865;108765;1125964;0,0002;-0,023079652;2006;1
2019.10.24 16:57:00;buy;19;107815;108425;105525;1127182;0,0106;0,516776316;1218;1
2019.10.24 17:00:01;buy;19;107755;108425;105525;1128628;-0,0006;-0,061684297;1446;1
2019.10.28 16:57:00;sell;19;108870;108040;110940;1130672;0,0103;0,504096041;2044;1
2019.10.28 17:00:01;sell;19;108820;108040;110940;1132526;-0,0005;-0,056638506;1854;1
2019.10.30 12:08:43;buy;38;107675;107670;104770;1130288;-0,0105;-0,578763234;-2238;0
2019.10.30 16:57:00;sell;19;108965;107630;110530;1134281;0,0120;0,588825108;3993;1
2019.10.30 17:00:01;sell;19;109030;107630;110530;1138521;0,0006;-0,001856831;4240;1
2019.11.01 15:24:08;sell;38;108410;108450;111350;1136057;-0,0057;-0,327865312;-2464;0
2019.11.05 12:00:13;buy;38;109530;109525;106625;1133839;0,0103;0,503245226;-2218;0
2019.11.05 16:57:00;sell;19;109125;108975;111875;1133299;-0,0037;-0,22466743;-540;0
2019.11.05 17:00:01;sell;19;109015;108975;111875;1132341;-0,0010;-0,085111834;-958;0
2019.11.08 11:59:06;sell;38;108595;108605;111505;1130045;-0,0039;-0,232713244;-2296;0
2019.11.08 16:57:00;buy;19;107775;109265;106365;1134607;-0,0076;-0,424608055;4562;1
2019.11.08 17:00:01;buy;19;107920;109265;106365;1138618;0,0013;0,037000085;4011;1
2019.11.12 16:57:00;buy;19;107165;107895;104995;1140292;-0,0070;-0,395807095;1674;1
2019.11.12 17:00:01;buy;19;107255;107895;104995;1141624;0,0008;0,010767551;1332;1
2019.11.14 16:57:00;sell;19;106965;106350;109250;1142851;-0,0027;-0,173103002;1227;1
2019.11.14 17:00:01;sell;19;106965;106350;109250;1144078;0,0000;-0,032808644;1227;1
2019.11.19 16:57:00;buy;19;106065;107190;104290;1147253;-0,0084;-0,469385361;3175;1
2019.11.19 17:00:01;buy;19;106020;107190;104290;1150599;-0,0004;-0,054822705;3346;1
2019.11.25 16:57:00;sell;19;108790;108470;111370;1150705;0,0261;1,322854303;106;1
2019.11.25 17:00:01;sell;19;108830;108470;111370;1150963;0,0004;-0,013730735;258;1
2019.11.28 16:57:00;sell;19;108520;107715;110615;1152942;-0,0028;-0,180608095;1979;1
2019.11.28 17:00:01;sell;19;108530;107715;110615;1154959;0,0001;-0,0280273;2017;1
2019.12.02 16:57:00;sell;19;109335;108910;111810;1155474;0,0074;0,352054067;515;1
2019.12.02 17:00:01;sell;19;109320;108910;111810;1155932;-0,0001;-0,039927198;458;1
2019.12.04 16:57:00;sell;19;110305;109520;112420;1157835;0,0090;0,434707233;1903;1
2019.12.04 17:00:01;sell;19;110290;109520;112420;1159681;-0,0001;-0,039864599;1846;1
2019.12.06 16:57:00;sell;9;111340;110860;113760;1160005;0,0095;0,461175398;324;1
2019.12.06 17:00:01;sell;9;111335;110860;113760;1160320;0,0000;-0,035138765;315;1
2019.12.10 15:16:21;buy;38;110605;110590;107690;1158026;-0,0066;-0,373021643;-2294;0
2019.12.11 14:00:02;sell;38;110885;110885;113785;1155806;0,0025;0,098545273;-2220;0
2019.12.12 16:57:00;sell;19;112345;111545;114445;1157746;0,0132;0,650378699;1940;1
2019.12.12 17:00:01;sell;19;112375;111545;114445;1159800;0,0003;-0,018952982;2054;1
2019.12.16 15:44:10;sell;38;112970;112985;115885;1157486;0,0053;0,241921946;-2314;0
2019.12.17 16:57:00;sell;19;112450;112145;115045;1157535;-0,0046;-0,271644744;49;1
2019.12.17 17:00:01;sell;19;112475;112145;115045;1157679;0,0002;-0,02127304;144;1
2019.12.20 14:00:19;sell;38;115395;115395;118295;1155459;0,0260;1,314250321;-2220;0
2019.12.23 16:57:00;buy;19;115875;116010;113110;1154872;0,0042;0,183022446;-587;0
2019.12.23 17:00:01;buy;19;115915;116010;113110;1154133;0,0003;-0,014897224;-739;0
2019.12.30 11:39:10;sell;38;117285;117295;120195;1151857;0,0118;0,580445773;-2276;0
2019.12.30 16:57:00;buy;19;116595;117100;114200;1152686;-0,0059;-0,338066166;829;1
2019.12.30 17:00:01;buy;19;116575;117100;114200;1153591;-0,0002;-0,04170905;905;1
2020.01.06 12:10:10;buy;38;117265;117260;114360;1151413;0,0059;0,27430805;-2178;0
2020.01.07 15:18:20;buy;38;117225;117220;114320;1149215;-0,0003;-0,05050775;-2198;0
2020.01.08 13:38:07;buy;18;116985;117380;114480;1149557;-0,0020;-0,139039518;342;1
2020.01.08 15:46:20;sell;38;116870;116885;119785;1147283;-0,0010;-0,083815366;-2274;0
2020.01.09 10:56:01;sell;38;116880;116880;119780;1145163;0,0001;-0,028368912;-2120;0
2020.01.09 13:05:21;buy;38;116750;116745;113845;1142985;-0,0011;-0,090520216;-2178;0
2020.01.09 16:57:00;buy;19;116355;116595;113695;1142797;-0,0034;-0,208358292;-188;0
2020.01.09 17:00:01;buy;19;116295;116595;113695;1142837;-0,0005;-0,059564937;40;1
2020.01.13 11:20:05;sell;38;116460;116470;119370;1140561;0,0014;0,040809126;-2276;0
2020.01.13 16:57:00;sell;19;117700;116880;119780;1142567;0,0106;0,519656212;2006;1
2020.01.13 17:00:01;sell;19;117625;116880;119780;1144288;-0,0006;-0,065871819;1721;1
2020.01.15 16:10:13;buy;38;116965;116960;114060;1142050;-0,0056;-0,323950104;-2238;0
2020.01.16 16:57:00;buy;19;116765;117340;114440;1143135;-0,0017;-0,121531155;1085;1
2020.01.16 17:00:01;buy;19;116750;117340;114440;1144277;-0,0001;-0,03947423;1142;1
2020.01.21 11:41:02;sell;38;118505;118505;121405;1142137;0,0150;0,747165109;-2140;0
2020.01.21 16:57:00;buy;19;117845;117900;115000;1141276;-0,0056;-0,321788132;-861;0
2020.01.21 17:00:01;buy;19;117805;117900;115000;1140567;-0,0003;-0,05042064;-709;0
2020.01.23 16:57:00;sell;19;119545;117485;120385;1147285;0,0148;0,733573331;6718;1
2020.01.23 17:00:01;sell;19;119585;117485;120385;1154155;0,0003;-0,0154471;6870;1
2020.02.03 11:00:14;buy;38;114020;113995;111095;1151765;-0,0465;-2,447425441;-2390;0
2020.02.03 16:57:00;sell;19;115220;114470;117370;1153515;0,0105;0,513276003;1750;1
2020.02.03 17:00:01;sell;19;115225;114470;117370;1155284;0,0000;-0,030556988;1769;1
2020.02.06 16:57:00;buy;9;114840;116960;114060;1158560;-0,0033;-0,206178572;3276;1
2020.02.06 17:00:01;buy;9;114795;116960;114060;1161917;-0,0004;-0,053140596;3357;1
2020.02.14 16:57:00;buy;19;115065;116215;113315;1165187;0,0024;0,089230893;3270;1
2020.02.14 17:00:01;buy;19;115030;116215;113315;1168590;-0,0003;-0,048591462;3403;1
2020.02.18 10:42:08;sell;38;114965;114980;117880;1166256;-0,0006;-0,06212851;-2334;0
2020.02.18 12:37:10;sell;38;114710;114710;117610;1164096;-0,0022;-0,14789777;-2160;0
2020.02.18 16:18:07;buy;38;114720;114715;111815;1161858;0,0001;-0,028285311;-2238;0
2020.02.19 16:57:00;sell;19;116990;115735;118635;1165537;0,0198;0,993898244;3679;1
2020.02.19 17:00:01;sell;19;117010;115735;118635;1169292;0,0002;-0,023938288;3755;1
2020.03.31 12:01:10;sell;38;74670;74680;77580;1167116;-0,3618;-18,8081409;-2176;0
2020.03.31 16:20:06;buy;19;72440;75240;72340;1176686;-0,0299;-1,582404579;9570;1
2020.03.31 16:20:07;buy;19;72280;75240;72340;1186864;-0,0022;-0,147413045;10178;1
2020.04.17 15:56:10;buy;38;78525;78520;75620;1184626;0,0864;4,450246239;-2238;0
2020.05.08 15:14:06;buy;38;80055;80050;77150;1182388;0,0195;0,978172936;-2238;0
2020.05.11 16:57:00;buy;19;79145;80380;77480;1185981;-0,0114;-0,622619398;3593;1
2020.05.11 17:00:01;buy;19;79020;80380;77480;1190049;-0,0016;-0,114758139;4068;1
2020.05.20 12:48:01;sell;38;82000;82000;84900;1187889;0,0377;1,923957815;-2160;0
2020.05.20 13:53:21;buy;38;81470;81440;78540;1185461;-0,0065;-0,368176762;-2428;0
2020.05.21 16:57:00;sell;19;83135;81795;84695;1189443;0,0204;1,027607372;3982;1
2020.05.21 17:00:01;sell;19;83085;81795;84695;1193235;-0,0006;-0,064015201;3792;1
2020.05.27 16:57:00;sell;19;88015;86610;89510;1197464;0,0593;3,046009604;4229;1
2020.05.27 17:00:01;sell;19;88075;86610;89510;1201921;0,0007;0,002562925;4457;1
2020.05.29 12:40:09;buy;38;86245;86240;83340;1199703;-0,0208;-1,11090653;-2218;0
2020.06.10 15:02:06;buy;38;95885;96170;93270;1199669;0,1118;5,766855763;-34;0
2020.06.22 16:57:00;buy;19;95495;96170;93270;1201134;-0,0041;-0,243852975;1465;1
2020.06.22 17:00:01;buy;19;95480;96170;93270;1202656;-0,0002;-0,040958883;1522;1
2020.06.26 16:57:00;buy;19;93755;94965;92065;1206154;-0,0181;-0,970233459;3498;1
2020.06.26 17:00:01;buy;19;93770;94965;92065;1209595;0,0002;-0,024507143;3441;1
2020.07.01 11:34:10;sell;38;96640;96640;99540;1207455;0,0306;1,555290961;-2140;0
2020.07.01 13:45:13;sell;38;96475;96475;99375;1205235;-0,0017;-0,121399067;-2220;0
2020.07.13 10:44:05;sell;38;100670;100675;103575;1202977;0,0435;2,223387927;-2258;0
2020.07.13 15:07:06;sell;38;100590;100590;103490;1200757;-0,0008;-0,074042094;-2220;0
2020.07.17 16:57:00;sell;19;103045;101585;104485;1205195;0,0244;1,233549201;4438;1
2020.07.17 17:00:01;sell;19;103050;101585;104485;1209652;0,0000;-0,03029095;4457;1
2020.07.22 16:52:20;buy;38;104520;104915;102015;1210514;0,0143;0,707357295;862;1
2020.07.23 10:41:13;sell;38;104600;104600;107500;1208294;0,0008;0,00690597;-2220;0
2020.07.23 12:50:08;buy;38;104410;104385;101485;1205924;-0,0018;-0,127058712;-2370;0
2020.07.23 16:57:00;buy;19;102325;103840;100940;1210601;-0,0200;-1,068961242;4677;1
2020.07.23 17:00:01;buy;19;102325;103840;100940;1215278;0,0000;-0,032808644;4677;1
2020.07.29 13:38:08;sell;38;104940;104940;107840;1213138;0,0256;1,293210203;-2140;0
2020.07.29 16:57:00;sell;19;105575;104905;107805;1214574;0,0061;0,281164443;1436;1
2020.07.29 17:00:01;sell;19;105555;104905;107805;1215934;-0,0002;-0,042638081;1360;1
2020.07.31 16:57:00;buy;9;103175;104950;102050;1218589;-0,0225;-1,202733326;2655;1
2020.07.31 17:00:01;buy;9;103325;104950;102050;1220974;0,0015;0,042626989;2385;1
2020.08.04 16:57:00;buy;19;101405;102455;99555;1223904;-0,0186;-0,996982989;2930;1
2020.08.04 17:00:01;buy;19;101425;102455;99555;1226758;0,0002;-0,022574998;2854;1
2020.08.07 14:26:02;buy;38;103140;103135;100235;1224540;0,0169;0,844553446;-2218;0
2020.08.07 16:46:21;buy;38;102755;103150;100250;1225342;-0,0037;-0,226492471;802;1
2020.08.10 14:05:14;buy;38;102255;102645;99745;1226106;-0,0049;-0,285288537;764;1
2020.08.24 13:40:08;buy;38;102145;102135;99235;1223830;-0,0011;-0,088625823;-2276;0
2020.08.25 16:57:00;buy;19;102045;102525;99625;1224564;-0,0010;-0,083606179;734;1
2020.08.25 17:00:01;buy;19;102075;102525;99625;1225184;0,0003;-0,017554449;620;1
2020.08.28 16:57:00;sell;19;102250;101655;104555;1226365;0,0017;0,056148006;1181;1
2020.08.28 17:00:01;sell;19;102330;101655;104555;1227850;0,0008;0,007787654;1485;1
2020.09.03 14:08:07;buy;19;100160;102970;100070;1237428;-0,0212;-1,133122334;9578;1
2020.09.03 14:44:14;buy;19;100070;102970;100070;1247348;-0,0009;-0,079432474;9920;1
2020.09.08 15:17:01;sell;38;100345;100350;103250;1245090;0,0027;0,109781186;-2258;0
2020.09.08 16:10:10;buy;38;100185;100180;97280;1242892;-0,0016;-0,11554264;-2198;0
2020.09.09 13:26:08;buy;38;100955;100935;98035;1240580;0,0077;0,365984589;-2312;0
2020.09.10 16:57:00;buy;19;98775;101130;98230;1248449;-0,0216;-1,15324816;7869;1
2020.09.10 17:00:01;buy;19;98710;101130;98230;1256565;-0,0007;-0,066953562;8116;1
2020.09.16 16:06:00;sell;38;99970;99970;102870;1254345;0,0128;0,629513309;-2220;0
2020.09.17 16:57:00;sell;9;100140;99435;102335;1255074;0,0017;0,05542597;729;1
2020.09.17 17:00:01;sell;9;100160;99435;102335;1255839;0,0002;-0,022445723;765;1
2020.09.23 15:17:04;sell;38;96480;96480;99380;1253619;-0,0367;-1,939205265;-2220;0
2020.09.24 10:38:07;sell;38;96000;96000;98900;1251419;-0,0050;-0,290953633;-2200;0
2020.09.24 15:51:10;sell;38;97080;96710;99610;1252111;0,0113;0,550921713;692;1
2020.09.25 11:27:05;buy;38;96110;96105;93205;1249993;-0,0100;-0,551252489;-2118;0
2020.09.28 16:57:00;buy;19;94510;96510;93610;1256493;-0,0166;-0,896604591;6500;1
2020.09.28 17:00:01;buy;19;94600;96510;93610;1262651;0,0010;0,016602454;6158;1
2020.10.01 14:20:15;buy;38;94315;94710;91810;1263493;-0,0030;-0,18912826;842;1
2020.10.01 16:57:00;sell;19;95480;94015;96915;1267970;0,0124;0,608112964;4477;1
2020.10.01 17:00:01;sell;19;95555;94015;96915;1272732;0,0008;0,007948957;4762;1
2020.10.07 14:44:04;buy;38;95860;95850;92950;1270456;0,0032;0,132808839;-2276;0
2020.10.08 12:19:10;sell;38;96265;96285;99185;1268084;0,0042;0,186409934;-2372;0
2020.10.13 16:57:00;sell;19;98780;97975;100875;1270083;0,0261;1,322784398;1999;1
2020.10.13 17:00:01;sell;19;98560;97975;100875;1271246;-0,0022;-0,148370209;1163;1
2020.10.15 16:57:00;sell;9;99300;98735;101635;1271723;0,0075;0,356766089;477;1
2020.10.15 17:00:01;sell;9;99250;98735;101635;1272110;-0,0005;-0,0589351;387;1
2020.10.19 15:01:04;sell;38;99520;99520;102420;1269930;0,0027;0,108345297;-2180;0
2020.10.19 16:57:00;buy;19;98725;99490;96590;1271737;-0,0080;-0,447300992;1807;1
2020.10.19 17:00:01;buy;19;98830;99490;96590;1273145;0,0011;0,022376467;1408;1
2020.10.22 11:51:07;buy;38;101050;101045;98145;1270907;0,0225;1,132722643;-2238;0
2020.10.22 16:57:00;sell;19;102085;101645;104545;1271469;0,0102;0,498643042;562;1
2020.10.22 17:00:01;sell;19;102095;101645;104545;1272069;0,0001;-0,027725904;600;1
2020.10.26 12:05:06;sell;38;101490;101490;104390;1269869;-0,0059;-0,340284244;-2200;0
2020.10.26 16:32:08;buy;18;101065;101455;98555;1270193;-0,0042;-0,250091486;324;1
2020.10.27 16:57:00;buy;19;99700;101305;98405;1275222;-0,0135;-0,733604665;5029;1
2020.10.27 17:00:01;buy;19;99635;101305;98405;1280498;-0,0007;-0,066636771;5276;1
2020.11.12 16:57:00;buy;19;102365;104690;101790;1288233;0,0274;1,38889959;7735;1
2020.11.12 17:00:01;buy;19;102235;104690;101790;1296462;-0,0013;-0,098703516;8229;1
2020.11.18 15:06:10;buy;38;107170;107155;104255;1294148;0,0483;2,471842893;-2314;0
2020.11.19 11:23:04;sell;38;106475;106475;109375;1291928;-0,0065;-0,369297999;-2220;0
2020.11.19 12:08:05;sell;38;106740;106740;109640;1289708;0,0025;0,096330524;-2220;0
2020.11.19 15:25:06;buy;38;106345;106740;103840;1290510;-0,0037;-0,224821211;802;1
2020.11.20 11:48:10;buy;38;106585;106580;103680;1288272;0,0023;0,084290555;-2238;0
2020.11.20 16:57:00;buy;19;106025;106445;103545;1288798;-0,0053;-0,305424865;526;1
2020.11.20 17:00:01;buy;19;106045;106445;103545;1289248;0,0002;-0,023020925;450;1
2020.11.24 16:57:00;sell;19;109780;108260;111160;1293924;0,0352;1,794703058;4676;1
2020.11.24 17:00:01;sell;19;109760;108260;111160;1298524;-0,0002;-0,042261575;4600;1
2020.11.26 16:57:00;sell;19;110140;109605;112505;1299467;0,0035;0,146829788;943;1
2020.11.26 17:00:01;sell;19;110155;109605;112505;1300467;0,0001;-0,025742118;1000;1
2020.11.30 10:56:10;sell;38;110605;110605;113505;1298247;0,0041;0,17915826;-2220;0
2020.11.30 12:55:10;buy;38;109915;109905;107005;1296011;-0,0062;-0,356502225;-2236;0
2020.11.30 14:32:13;buy;38;109720;109715;106815;1293873;-0,0018;-0,124861529;-2138;0
2020.12.03 16:57:00;sell;19;113095;112430;115330;1295290;0,0308;1,563245923;1417;1
2020.12.03 17:00:01;sell;19;113080;112430;115330;1296650;-0,0001;-0,039690532;1360;1
2020.12.07 16:57:00;sell;19;114010;113605;116505;1297079;0,0082;0,393925021;429;1
2020.12.07 16:59:06;sell;19;113595;113605;116505;1295931;-0,0036;-0,221679482;-1148;0
2020.12.08 14:25:04;sell;38;113675;113700;116600;1293521;0,0007;0,003733206;-2410;0
2020.12.09 16:57:00;buy;19;112780;113895;110995;1296668;-0,0079;-0,441332882;3147;1
2020.12.09 17:00:01;buy;19;112740;113895;110995;1299967;-0,0004;-0,051211603;3299;1
2020.12.14 11:30:05;buy;18;115265;115260;112360;1298869;0,0224;1,129290306;-1098;0
2020.12.14 14:45:04;sell;38;114960;114965;117865;1296611;-0,0026;-0,170105989;-2258;0
2020.12.15 16:57:00;sell;19;116010;114970;117870;1299463;0,0091;0,441108371;2852;1
2020.12.15 17:00:01;sell;19;116075;114970;117870;1302562;0,0006;-0,003736458;3099;1
2020.12.18 14:41:07;buy;38;118865;118840;115940;1300172;0,0240;1,214360243;-2390;0
2020.12.23 16:57:00;sell;19;118080;117110;120010;1302798;-0,0066;-0,375478118;2626;1
2020.12.23 17:00:01;sell;19;118000;117110;120010;1305120;-0,0007;-0,067962534;2322;1
2020.12.29 16:57:00;sell;19;119575;119055;121955;1306006;0,0133;0,659752797;886;1
2020.12.29 17:00:01;sell;19;119615;119055;121955;1307044;0,0003;-0,015451456;1038;1
2021.01.04 16:57:00;buy;9;119010;120415;117515;1309033;-0,0051;-0,295248316;1989;1
2021.01.04 17:00:01;buy;9;119025;120415;117515;1310995;0,0001;-0,026268797;1962;1
2021.01.13 16:03:08;buy;38;122455;122850;119950;1311797;0,0288;1,462447814;802;1
2021.01.19 16:57:00;buy;9;120660;121885;118985;1313462;-0,0147;-0,793393523;1665;1
2021.01.19 17:00:01;buy;9;120590;121885;118985;1315253;-0,0006;-0,062910583;1791;1
2021.02.05 11:32:05;sell;38;120170;120170;123070;1313073;-0,0035;-0,213525121;-2180;0
2021.02.05 12:44:08;buy;38;120160;120150;117250;1310797;-0,0001;-0,037126455;-2276;0
2021.02.05 16:23:10;sell;38;120600;120610;123510;1308541;0,0037;0,157190881;-2256;0
2021.02.08 10:54:07;buy;38;119750;119725;116825;1306151;-0,0070;-0,398514045;-2390;0
2021.02.09 11:33:07;buy;38;118775;118760;115860;1303837;-0,0081;-0,455271811;-2314;0
2021.02.09 16:57:00;sell;19;119670;118425;121325;1307458;0,0075;0,358174247;3621;1
2021.02.09 17:00:01;sell;19;119725;118425;121325;1311288;0,0005;-0,008961457;3830;1
2021.02.11 14:17:08;sell;38;119230;119230;122130;1309068;-0,0041;-0,24733473;-2220;0
2021.02.12 15:00:09;sell;38;119395;119405;122305;1306772;0,0014;0,03899693;-2296;0
2021.02.17 16:57:00;sell;19;120555;119495;122395;1309730;0,0097;0,471308662;2958;1
2021.02.17 17:00:01;sell;19;120505;119495;122395;1312498;-0,0004;-0,054328756;2768;1
2021.02.25 15:03:04;buy;19;113700;116515;113615;1322095;-0,0565;-2,962911186;9597;1
2021.02.25 15:04:08;buy;19;113620;116515;113615;1331996;-0,0007;-0,069316748;9901;1
2021.02.25 15:19:14;buy;38;113940;113915;111015;1329606;0,0028;0,113326594;-2390;0
2021.02.25 16:15:04;buy;38;113845;113840;110940;1327388;-0,0008;-0,076070699;-2218;0
2021.03.15 12:38:07;sell;38;114055;114065;116965;1325112;0,0018;0,06290307;-2276;0
2021.03.15 16:43:01;sell;38;114545;114555;117455;1322816;0,0043;0,190107493;-2296;0
2021.03.16 16:25:21;buy;38;114055;114045;111145;1320560;-0,0043;-0,254771191;-2256;0
2021.03.17 15:49:08;sell;19;116315;113510;116410;1330129;0,0198;0,995335171;9569;1
2021.03.17 15:52:13;sell;19;116410;113510;116410;1340059;0,0008;0,009570057;9930;1
2021.03.17 16:57:00;sell;19;116580;116115;119015;1340736;0,0015;0,042965038;677;1
2021.03.17 17:00:01;sell;19;116660;116115;119015;1341717;0,0007;0,002797562;981;1
2021.03.22 11:26:14;buy;38;114490;114475;111575;1339403;-0,0186;-0,997964652;-2314;0
2021.03.30 16:57:00;sell;19;116830;115790;118690;1342255;0,0204;1,027684973;2852;1
2021.03.30 17:00:01;sell;19;116910;115790;118690;1345411;0,0007;0,002721369;3156;1
2021.04.01 16:57:00;buy;19;115245;117025;114125;1351075;-0,0142;-0,771771032;5664;1
2021.04.01 17:00:01;buy;19;115135;117025;114125;1357157;-0,0010;-0,082334312;6082;1
2021.04.07 13:45:10;buy;38;117485;117880;114980;1357979;0,0204;1,026250597;822;1
2021.04.07 15:55:06;sell;38;117585;117185;120085;1358839;0,0009;0,011356265;860;1
2021.04.08 10:40:06;buy;38;117945;117940;115040;1356621;0,0031;0,126049811;-2218;0
2021.04.08 16:57:00;sell;19;118400;117935;120835;1357278;0,0039;0,167357959;657;1
2021.04.08 17:00:01;sell;19;118360;117935;120835;1357783;-0,0003;-0,050338084;505;1
2021.04.12 15:40:06;sell;38;118460;118470;121370;1355507;0,0008;0,011029767;-2276;0
2021.04.13 10:51:06;buy;38;118405;118400;115500;1353269;-0,0005;-0,056899416;-2238;0
2021.04.13 16:57:00;sell;19;119150;118740;121640;1353737;0,0063;0,293663392;468;1
2021.04.13 17:00:01;sell;19;119135;118740;121640;1354148;-0,0001;-0,039340806;411;1
2021.04.16 10:53:08;sell;38;120905;120910;123810;1351930;0,0149;0,738083561;-2218;0
2021.04.16 16:57:00;sell;19;121430;120730;123630;1353490;0,0043;0,192498416;1560;1
2021.04.16 17:00:01;sell;19;121500;120730;123630;1355316;0,0006;-0,002897584;1826;1
2021.04.20 12:58:14;buy;38;120855;120835;117935;1353004;-0,0053;-0,308258908;-2312;0
2021.04.20 14:44:14;buy;38;120635;120630;117730;1350806;-0,0018;-0,127262091;-2198;0
2021.04.22 11:20:01;buy;38;120600;120585;117685;1348492;-0,0003;-0,047862732;-2314;0
2021.04.22 13:37:08;sell;38;120635;120650;123550;1346198;0,0003;-0,017750186;-2294;0
2021.04.22 15:26:08;buy;38;120300;120280;117380;1343846;-0,0028;-0,176897779;-2352;0
2021.04.23 11:01:08;sell;38;120820;120835;123735;1341592;0,0043;0,191474933;-2254;0
2021.04.23 14:57:21;sell;38;120640;120645;123545;1339334;-0,0015;-0,110111124;-2258;0
2021.04.26 16:57:00;buy;19;120965;121115;118215;1338804;0,0027;0,10697353;-530;0
2021.04.26 17:00:01;buy;19;121060;121115;118215;1337913;0,0008;0,007940983;-891;0
2021.04.28 16:57:00;sell;19;121460;121255;124155;1337582;0,0033;0,138634088;-331;0
2021.04.28 17:00:01;sell;19;121425;121255;124155;1337118;-0,0003;-0,04776048;-464;0
2021.04.30 14:52:10;sell;38;119795;119800;122700;1334880;-0,0134;-0,729337717;-2238;0
2021.05.03 15:47:08;buy;38;119645;120030;117130;1335646;-0,0013;-0,097778562;766;1
2021.05.04 13:13:01;buy;38;119005;118995;116095;1333450;-0,0053;-0,310361165;-2196;0
2021.05.05 16:57:00;sell;9;120070;118990;121890;1334854;0,0089;0,431539973;1404;1
2021.05.05 17:00:01;sell;9;120055;118990;121890;1336231;-0,0001;-0,039290755;1377;1
2021.05.07 16:57:00;sell;19;122265;120965;123865;1340061;0,0184;0,922341793;3830;1
2021.05.07 17:00:01;sell;19;122385;120965;123865;1344347;0,0010;0,018117273;4286;1
2021.05.11 16:57:00;sell;19;123065;121590;124490;1348842;0,0056;0,255488592;4495;1
2021.05.11 17:00:01;sell;19;123090;121590;124490;1353432;0,0002;-0,022268047;4590;1
2021.05.17 12:10:14;sell;38;122370;122370;125270;1351252;-0,0058;-0,336316181;-2180;0
2021.05.17 16:57:00;sell;19;123140;122185;125085;1353771;0,0063;0,293685595;2519;1
2021.05.17 17:00:01;sell;19;123200;122185;125085;1356518;0,0005;-0,007526618;2747;1
2021.05.19 15:11:05;sell;38;122320;121945;124845;1357148;-0,0071;-0,403431092;630;1
2021.05.19 15:23:03;buy;38;122725;122720;119820;1354950;0,0033;0,138989042;-2198;0
2021.05.20 12:07:10;sell;38;122665;122665;125565;1352730;-0,0005;-0,058176161;-2220;0
2021.05.20 16:57:00;sell;19;122835;122330;125230;1353539;0,0014;0,039101146;809;1
2021.05.20 17:00:01;sell;19;122875;122330;125230;1354500;0,0003;-0,01591211;961;1
2021.05.24 11:08:14;sell;38;123485;123490;126390;1352242;0,0050;0,224779614;-2258;0
2021.05.24 16:57:00;sell;19;124285;123245;126145;1355094;0,0065;0,303343231;2852;1
2021.05.24 17:00:01;sell;19;124250;123245;126145;1357813;-0,0003;-0,047420624;2719;1
2021.05.26 13:41:01;sell;38;124015;124020;126920;1355555;-0,0019;-0,130945292;-2258;0
2021.05.27 11:13:08;sell;38;124355;124355;127255;1353335;0,0027;0,109445346;-2220;0
2021.05.27 14:47:09;buy;38;124240;124235;121335;1351117;-0,0009;-0,080792411;-2218;0
2021.05.28 11:18:10;sell;38;124665;124665;127565;1348937;0,0034;0,144686814;-2180;0
2021.05.28 16:57:00;sell;19;125695;125165;128065;1349861;0,0083;0,395890326;924;1
2021.05.28 17:00:01;sell;19;125675;125165;128065;1350709;-0,0002;-0,041064683;848;1
2021.06.04 12:18:14;buy;38;129550;129530;126630;1348377;0,0308;1,567053528;-2332;0
2021.06.04 14:28:16;buy;38;129750;129745;126845;1346139;0,0015;0,047295012;-2238;0
2021.06.07 16:57:00;sell;19;130760;129780;132680;1348753;0,0078;0,371091274;2614;1
2021.06.07 17:00:01;sell;19;130820;129780;132680;1351595;0,0005;-0,008999921;2842;1
2021.06.09 11:15:00;sell;38;129930;129950;132850;1349243;-0,0068;-0,385809386;-2352;0
2021.06.09 15:13:10;sell;38;130270;130285;133185;1346909;0,0026;0,102969303;-2334;0
2021.06.09 16:57:00;buy;19;129875;130355;127455;1347633;-0,0030;-0,190138968;724;1
2021.06.09 17:00:01;buy;19;129935;130355;127455;1348129;0,0005;-0,008837682;496;1
2021.06.11 16:57:00;buy;19;129350;129530;126630;1347713;-0,0045;-0,266417591;-416;0
2021.06.11 17:00:01;buy;19;129390;129530;126630;1347145;0,0003;-0,016763141;-568;0
2021.06.15 13:13:08;buy;38;129655;129645;126745;1344869;0,0020;0,073459946;-2276;0
2021.06.15 16:57:00;sell;19;130060;129560;132460;1345679;0,0031;0,129269894;810;1
2021.06.15 17:00:01;sell;19;130110;129560;132460;1346679;0,0004;-0,012861257;1000;1
2021.06.17 11:49:59;sell;38;130175;130180;133080;1344421;0,0005;-0,006887006;-2258;0
2021.06.17 16:57:00;buy;19;128685;129405;126505;1346087;-0,0114;-0,626715636;1666;1
2021.06.17 17:00:01;buy;19;128680;129405;126505;1347772;0,0000;-0,034824696;1685;1
2021.06.21 13:50:08;sell;38;129450;129460;132360;1345476;0,0060;0,277675503;-2296;0
2021.06.22 12:29:21;buy;38;129170;129165;126265;1343238;-0,0022;-0,145040393;-2238;0
2021.06.23 13:34:13;sell;38;129825;129825;132725;1341018;0,0051;0,230302594;-2220;0
2021.06.23 14:31:14;buy;38;129450;129435;126535;1338744;-0,0029;-0,18268485;-2274;0
2021.06.24 16:45:16;buy;38;130130;130115;127215;1336430;0,0053;0,239754177;-2314;0
2021.06.25 16:57:00;buy;19;127720;129590;126690;1342446;-0,0185;-0,993755498;6016;1
2021.06.25 17:00:01;buy;19;127945;129590;126690;1347607;0,0018;0,058599179;5161;1
2021.06.30 14:32:10;sell;38;127170;127175;130075;1345389;-0,0061;-0,347104127;-2218;0
2021.07.01 16:57:00;buy;19;126215;126750;123850;1346332;-0,0075;-0,422462032;943;1
2021.07.01 17:00:01;buy;19;126195;126750;123850;1347351;-0,0002;-0,041030668;1019;1
2021.07.15 16:30:06;buy;38;128040;128430;125530;1348155;0,0146;0,725793349;804;1
2021.07.16 16:57:00;buy;19;126295;128345;125445;1354845;-0,0136;-0,739955349;6690;1
2021.07.16 17:00:01;buy;19;126365;128345;125445;1361269;0,0006;-0,004049785;6424;1
2021.07.22 11:19:13;buy;38;126115;126105;123205;1358993;-0,0020;-0,135461955;-2276;0
2021.07.22 16:57:00;sell;19;126585;126295;129195;1359005;0,0037;0,160562146;12;1
2021.07.22 17:00:01;sell;19;126605;126295;129195;1359093;0,0002;-0,024610651;88;1
2021.07.26 16:57:00;sell;9;126275;125595;128495;1359777;-0,0026;-0,168054148;684;1
2021.07.26 17:00:01;sell;9;126320;125595;128495;1360542;0,0004;-0,014317878;765;1
2021.07.30 16:57:00;buy;19;121945;124465;121565;1369048;-0,0346;-1,829881552;8506;1
2021.07.30 17:00:01;buy;19;121985;124465;121565;1377402;0,0003;-0,015788793;8354;1
2021.08.09 15:55:14;sell;38;123345;123360;126260;1375068;0,0111;0,545676533;-2334;0
2021.08.10 16:57:00;buy;19;122340;123465;120565;1378243;-0,0081;-0,455578748;3175;1
2021.08.10 17:00:01;buy;19;122275;123465;120565;1381665;-0,0005;-0,060376604;3422;1
2021.08.12 16:57:00;buy;19;120635;121825;118925;1385087;-0,0134;-0,728739244;3422;1
2021.08.12 17:00:01;buy;19;120625;121825;118925;1388547;-0,0001;-0,037109812;3460;1
2021.08.16 11:40:02;buy;38;119655;119650;116750;1386309;-0,0080;-0,450056548;-2238;0
2021.08.16 14:03:14;buy;38;119285;119280;116380;1384111;-0,0031;-0,193255285;-2198;0
2021.08.24 16:57:00;sell;9;120750;119475;122375;1385866;0,0123;0,604443854;1755;1
2021.08.24 17:00:01;sell;9;120805;119475;122375;1387720;0,0005;-0,009174748;1854;1
2021.08.26 16:57:00;buy;19;119540;121045;118145;1392339;-0,0105;-0,576140754;4619;1
2021.08.26 17:00:01;buy;19;119470;121045;118145;1397224;-0,0006;-0,063192615;4885;1
2021.08.30 14:18:07;sell;38;120370;120375;123275;1394966;0,0075;0,358071314;-2258;0
2021.08.30 15:29:07;buy;38;120500;120495;117595;1392728;0,0011;0,023229643;-2238;0
2021.08.31 10:48:01;sell;38;120340;120350;123250;1390432;-0,0013;-0,101704435;-2296;0
2021.08.31 12:25:09;buy;38;120365;120360;117460;1388234;0,0002;-0,022029363;-2198;0
2021.08.31 16:57:00;buy;19;119105;119210;116310;1387533;-0,0105;-0,575971523;-701;0
2021.08.31 17:00:01;buy;19;118925;119210;116310;1387516;-0,0015;-0,111224207;-17;0
2021.09.02 11:26:10;buy;38;118730;118715;115815;1385242;-0,0016;-0,117887415;-2274;0
2021.09.02 13:24:05;buy;38;118400;118395;115495;1383064;-0,0028;-0,177024572;-2178;0
2021.09.15 10:49:07;buy;38;116105;116085;113185;1380752;-0,0194;-1,038560272;-2312;0
2021.09.15 13:49:08;buy;38;115675;115655;112755;1378400;-0,0037;-0,224974971;-2352;0
2021.09.27 12:28:06;sell;38;113410;113415;116315;1376142;-0,0196;-1,048796355;-2258;0
2021.09.27 14:32:05;sell;38;113415;113415;116315;1373922;0,0000;-0,030521052;-2220;0
2021.09.27 15:17:08;buy;38;112980;112970;110070;1371686;-0,0038;-0,231820301;-2236;0
2021.09.28 11:39:04;buy;38;112095;112065;109165;1369298;-0,0078;-0,439253336;-2388;0
2021.09.28 12:33:01;buy;38;111600;111580;108680;1366946;-0,0044;-0,261936934;-2352;0
2021.10.01 16:57:00;sell;19;112755;112485;115385;1366882;0,0103;0,504195388;-64;0
2021.10.01 17:00:01;sell;19;112750;112485;115385;1366799;0,0000;-0,035109523;-83;0
2021.10.13 16:50:14;sell;38;114605;114205;117105;1367659;0,0165;0,820855657;860;1
2021.10.15 16:57:00;sell;19;115740;114935;117835;1369618;0,0099;0,481059923;1959;1
2021.10.15 17:00:01;sell;19;115675;114935;117835;1371330;-0,0006;-0,061948649;1712;1
2021.10.28 11:23:01;sell;38;107475;107475;110375;1369130;-0,0709;-3,710998149;-2200;0
2021.10.28 13:15:04;buy;38;106940;106925;104025;1366836;-0,0050;-0,291097747;-2294;0
