date,Tipo,Volume,Price,SL,TP,Saldo,Price Vol,Scaled Price Return,Retorno,Dummy,Open,High,Low,Close,Tick,Vol,Returns,Scaled Returns,Proba Returns,Candle Size,MM20,MM10,MM5,MM2
2019-04-02 15:30:14,buy,38,95640,96035,93135,1093457,0.0059,0.275539878,862,1,95550.0,95570.0,95545.0,95565.0,141,710,0.0,-0.04387610657508834,0.39932646970460567,25.0,12.0,11.5,12.0,10.0
2019-04-02 15:53:14,sell,38,95315,95340,98240,1091047,-0.0034,-0.209129445,-2410,0,95465.0,95465.0,95460.0,95465.0,32,108,-0.001046408203840318,-0.04387610657508834,0.39932646970460567,5.0,12.0,11.5,12.0,15.0
2019-04-03 14:43:08,sell,38,96075,96075,98975,1088827,0.008,0.380916673,-2220,0,96315.0,96320.0,96305.0,96310.0,331,1016,0.008851411512072487,-0.04387610657508834,0.39932646970460567,15.0,12.0,11.5,12.0,10.0
2019-04-03 16:57:00,buy,9,94665,96035,93135,1090753,-0.0147,-0.794306134,1926,1,94660.0,94670.0,94660.0,94670.0,31,65,-0.017028345966150972,-0.04387610657508834,0.39932646970460567,10.0,12.0,11.5,12.0,12.5
2019-04-03 17:00:01,buy,9,94670,96035,93135,1092670,0.0001,-0.030068077,1917,1,94670.0,94675.0,94660.0,94670.0,151,330,0.0,-0.04387610657508834,0.39932646970460567,15.0,12.0,11.5,14.0,12.5
2019-04-05 16:57:00,sell,19,97200,96870,99770,1092824,0.0267,1.353844692,154,1,97200.0,97200.0,97195.0,97195.0,20,47,0.026671596070560896,-0.04387610657508834,0.39932646970460567,5.0,12.0,11.5,10.0,10.0
2019-04-05 17:00:01,sell,19,97240,96870,99770,1093130,0.0004,-0.01145591,306,1,97240.0,97240.0,97235.0,97235.0,19,67,0.00041154380369360564,-0.04387610657508834,0.39932646970460567,5.0,12.0,11.5,10.0,5.0
2019-04-09 12:08:21,sell,38,96270,96275,99175,1090912,-0.01,-0.550399435,-2218,0,96390.0,96390.0,96385.0,96390.0,4,15,-0.008690286419499151,-0.04387610657508834,0.39932646970460567,5.0,12.0,11.5,8.0,5.0
2019-04-09 15:28:02,buy,38,96215,96210,93310,1088674,-0.0006,-0.06245228,-2238,0,96195.0,96195.0,96190.0,96190.0,100,330,-0.0020749040356883492,-0.04387610657508834,0.39932646970460567,5.0,12.0,11.5,7.0,5.0
2019-04-10 16:57:00,buy,19,95955,96730,93830,1090539,-0.0027,-0.173022302,1865,1,95950.0,95955.0,95945.0,95955.0,96,483,-0.002443081401393076,-0.04387610657508834,0.39932646970460567,10.0,12.0,10.0,6.0,7.5
2019-04-10 17:00:01,buy,19,96005,96730,93830,1092214,0.0005,-0.005771416,1675,1,95995.0,96005.0,95995.0,96005.0,44,164,0.0005210775884529206,-0.04387610657508834,0.39932646970460567,10.0,12.0,8.5,7.0,10.0
2019-04-16 16:57:00,sell,19,94320,93045,95945,1095949,-0.0176,-0.943488667,3735,1,94320.0,94325.0,94320.0,94325.0,9,12,-0.017499088589135983,-0.04387610657508834,0.39932646970460567,5.0,12.0,8.5,7.0,7.5
2019-04-16 17:00:01,sell,19,94240,93045,95945,1099380,-0.0008,-0.076818095,3431,1,94225.0,94240.0,94210.0,94235.0,181,526,-0.0009541478929234031,-0.04387610657508834,0.39932646970460567,30.0,12.0,10.0,12.0,17.5
2019-04-18 16:57:00,sell,9,95210,94315,97215,1100451,0.0103,0.501258934,1071,1,95210.0,95225.0,95210.0,95215.0,54,178,0.010399533082188146,-0.04387610657508834,0.39932646970460567,15.0,12.0,10.5,14.0,22.5
2019-04-18 17:00:01,sell,9,95205,94315,97215,1101513,-0.0001,-0.035533522,1062,1,95190.0,95210.0,95190.0,95205.0,79,236,-0.00010502546867615396,-0.04387610657508834,0.39932646970460567,20.0,12.0,11.0,16.0,17.5
2019-04-23 16:57:00,sell,19,96515,96055,98955,1102161,0.0138,0.681147105,648,1,96515.0,96520.0,96515.0,96520.0,48,289,0.013812299774171524,-0.04387610657508834,0.39932646970460567,5.0,12.0,11.0,15.0,12.5
2019-04-23 17:00:01,sell,19,96605,96055,98955,1103151,0.0009,0.015575989,990,1,96610.0,96615.0,96605.0,96610.0,44,97,0.0009324492333195193,-0.04387610657508834,0.39932646970460567,10.0,12.0,11.5,16.0,7.5
2019-04-29 13:52:15,buy,38,97150,97145,94245,1100953,0.0056,0.259914226,-2198,0,97145.0,97155.0,97145.0,97155.0,136,425,0.005641237967084153,-0.04387610657508834,0.39932646970460567,10.0,12.0,12.0,12.0,10.0
2019-04-29 16:40:16,buy,38,97075,97070,94170,1098715,-0.0008,-0.072865625,-2238,0,97070.0,97075.0,97070.0,97070.0,30,199,-0.0008748906386701663,-0.04387610657508834,0.39932646970460567,5.0,12.0,12.0,10.0,7.5
2019-04-30 16:55:32,buy,38,97170,97165,94265,1096477,0.001,0.0179694,-2238,0,97170.0,97180.0,97170.0,97170.0,72,299,0.0010301844030081385,-0.04387610657508834,0.39932646970460567,10.0,11.0,12.0,8.0,7.5
2019-05-02 11:25:21,sell,38,96165,96165,99065,1094257,-0.0103,-0.569461711,-2220,0,96245.0,96260.0,96245.0,96250.0,50,244,-0.00946794278069363,-0.04387610657508834,0.39932646970460567,15.0,10.5,12.5,10.0,12.5
2019-05-02 14:12:21,buy,38,96305,96300,93400,1092059,0.0015,0.042730274,-2198,0,96230.0,96235.0,96225.0,96235.0,14,62,-0.00015584415584415584,-0.04387610657508834,0.39932646970460567,10.0,10.75,13.0,10.0,12.5
2019-05-02 16:57:00,buy,19,96210,96500,93600,1092061,-0.001,-0.083992679,2,1,96205.0,96210.0,96205.0,96205.0,12,33,-0.00031173689406141216,-0.04387610657508834,0.39932646970460567,5.0,10.25,10.5,9.0,7.5
2019-05-02 17:00:01,buy,19,96170,96500,93600,1092215,-0.0004,-0.054381097,154,1,96175.0,96185.0,96175.0,96175.0,43,196,-0.0003118341042565355,-0.04387610657508834,0.39932646970460567,10.0,10.25,10.0,10.0,7.5
2019-05-06 16:57:00,sell,19,95530,95250,98150,1092169,-0.0067,-0.378111455,-46,0,95530.0,95530.0,95525.0,95525.0,8,13,-0.006758513127112035,-0.04387610657508834,0.39932646970460567,5.0,9.75,8.5,9.0,7.5
2019-05-06 17:00:01,sell,19,95535,95250,98150,1092142,0.0001,-0.030092892,-27,0,95545.0,95560.0,95545.0,95545.0,125,540,0.0002093692750588851,-0.04387610657508834,0.39932646970460567,15.0,10.25,9.5,9.0,10.0
2019-05-08 16:57:00,sell,19,96220,96015,98915,1091811,0.0072,0.339229801,-331,0,96220.0,96225.0,96215.0,96215.0,13,20,0.00701240253283793,-0.04387610657508834,0.39932646970460567,10.0,10.5,9.5,9.0,12.5
2019-05-08 17:00:01,sell,19,96215,96015,98915,1091461,-0.0001,-0.03550492,-350,0,96215.0,96230.0,96210.0,96225.0,148,523,0.00010393389804084603,-0.04387610657508834,0.39932646970460567,20.0,11.25,10.5,12.0,15.0
2019-05-15 11:36:02,sell,38,91280,91290,94190,1089225,-0.0513,-2.694171734,-2236,0,91285.0,91295.0,91275.0,91275.0,288,881,-0.05144193296960249,-0.04387610657508834,0.39932646970460567,20.0,12.0,12.0,14.0,20.0
2019-05-15 14:51:16,buy,38,91925,91920,89020,1087007,0.0071,0.33383473,-2218,0,91880.0,91885.0,91880.0,91880.0,11,20,0.006628321007943029,-0.04387610657508834,0.39932646970460567,5.0,11.75,11.5,14.0,12.5
2019-05-15 16:57:00,buy,19,91570,92130,89230,1088065,-0.0039,-0.233188689,1058,1,91565.0,91570.0,91555.0,91560.0,142,717,-0.0034828036569438396,-0.04387610657508834,0.39932646970460567,15.0,12.0,11.5,14.0,10.0
2019-05-15 17:00:01,buy,19,91580,92130,89230,1089085,0.0001,-0.027142253,1020,1,91580.0,91590.0,91580.0,91580.0,67,270,0.00021843599825251202,-0.04387610657508834,0.39932646970460567,10.0,12.25,11.5,14.0,12.5
2019-05-17 14:58:16,sell,38,90655,90265,93165,1089829,-0.0101,-0.556892582,744,1,90695.0,90705.0,90685.0,90685.0,137,512,-0.009772876173837082,-0.04387610657508834,0.39932646970460567,20.0,11.75,13.0,14.0,15.0
2019-05-17 16:57:00,buy,9,90165,90885,87985,1090585,-0.0054,-0.313264217,756,1,90160.0,90160.0,90150.0,90155.0,30,90,-0.005844406461928654,-0.04387610657508834,0.39932646970460567,10.0,11.5,13.0,12.0,15.0
2019-05-17 17:00:01,buy,9,90165,90885,87985,1091341,0.0,-0.032808644,756,1,90175.0,90185.0,90175.0,90180.0,39,150,0.00027730020520215184,-0.04387610657508834,0.39932646970460567,10.0,11.0,13.5,13.0,10.0
2019-05-23 16:57:00,buy,19,94150,94715,91815,1092418,0.0442,2.260434457,1077,1,94145.0,94150.0,94145.0,94145.0,15,54,0.0439676203149257,-0.04387610657508834,0.39932646970460567,5.0,11.0,12.5,11.0,7.5
2019-05-23 17:00:01,buy,19,94215,94715,91815,1093248,0.0007,0.003013601,830,1,94205.0,94205.0,94195.0,94205.0,61,181,0.0006373147803919486,-0.04387610657508834,0.39932646970460567,10.0,11.0,12.5,11.0,7.5
2019-05-27 15:37:42,sell,38,94975,94575,97475,1094068,0.0081,0.385747091,820,1,94980.0,94990.0,94980.0,94980.0,22,32,0.008226739557348336,-0.04387610657508834,0.39932646970460567,10.0,11.0,11.5,9.0,10.0
2019-05-28 11:29:08,buy,38,95475,95470,92570,1091850,0.0053,0.240353467,-2218,0,95445.0,95450.0,95440.0,95445.0,95,339,0.004895767530006317,-0.04387610657508834,0.39932646970460567,10.0,11.25,10.5,9.0,10.0
2019-05-28 16:57:00,sell,9,96415,95795,98695,1092426,0.0098,0.478046703,576,1,96415.0,96415.0,96400.0,96405.0,105,296,0.010058148672010058,-0.04387610657508834,0.39932646970460567,15.0,11.5,11.5,10.0,12.5
2019-05-28 17:00:01,sell,9,96380,95795,98695,1092939,-0.0004,-0.051644406,513,1,96395.0,96400.0,96385.0,96395.0,131,308,-0.00010372905969607386,-0.04387610657508834,0.39932646970460567,15.0,11.5,11.5,12.0,15.0
2019-05-30 16:57:00,sell,9,97765,96820,99720,1094100,0.0144,0.712820043,1161,1,97765.0,97770.0,97755.0,97770.0,97,370,0.014264225322890192,-0.04387610657508834,0.39932646970460567,15.0,11.75,12.0,13.0,15.0
2019-05-30 17:00:01,sell,9,97765,96820,99720,1095261,0.0,-0.032808644,1161,1,97760.0,97760.0,97755.0,97755.0,36,110,-0.00015342129487572875,-0.04387610657508834,0.39932646970460567,5.0,11.75,10.5,12.0,10.0
2019-06-03 11:50:21,sell,38,97215,97230,100130,1092927,-0.0056,-0.324711968,-2334,0,97310.0,97315.0,97305.0,97310.0,64,330,-0.004552196818577055,-0.04387610657508834,0.39932646970460567,10.0,11.75,10.5,12.0,7.5
2019-06-03 14:26:09,buy,38,97520,97510,94610,1090671,0.0031,0.129980829,-2256,0,97490.0,97495.0,97475.0,97495.0,169,519,0.0019011406844106464,-0.04387610657508834,0.39932646970460567,20.0,12.5,11.5,13.0,15.0
2019-06-03 16:57:00,buy,19,97005,97430,94530,1091206,-0.0053,-0.306822985,535,1,97000.0,97000.0,96995.0,96995.0,24,107,-0.005128468126570593,-0.04387610657508834,0.39932646970460567,5.0,12.0,11.5,11.0,12.5
2019-06-03 17:00:01,buy,19,96990,97430,94530,1091798,-0.0002,-0.040832015,592,1,96995.0,96995.0,96985.0,96990.0,39,218,-5.1549048920047426e-05,-0.04387610657508834,0.39932646970460567,10.0,12.0,11.5,10.0,7.5
2019-06-05 16:57:00,buy,19,96145,97375,94475,1095392,-0.0087,-0.4848618,3594,1,96140.0,96145.0,96135.0,96145.0,17,69,-0.008712238375090215,-0.04387610657508834,0.39932646970460567,10.0,11.5,11.5,11.0,10.0
2019-06-05 17:00:01,buy,19,96095,97375,94475,1099176,-0.0005,-0.05979244,3784,1,96085.0,96085.0,96075.0,96075.0,50,263,-0.0007280669821623589,-0.04387610657508834,0.39932646970460567,10.0,11.0,11.5,11.0,10.0
2019-06-07 10:40:10,buy,38,97615,97610,94710,1096998,0.0158,0.787925599,-2178,0,97615.0,97620.0,97600.0,97620.0,297,856,0.01608118657298985,-0.04387610657508834,0.39932646970460567,20.0,11.75,12.0,11.0,15.0
2019-06-07 13:36:32,sell,38,98020,98020,100920,1094778,0.0041,0.182468648,-2220,0,98025.0,98025.0,98020.0,98025.0,17,29,0.004148740012292563,-0.04387610657508834,0.39932646970460567,5.0,11.25,11.0,11.0,12.5
2019-06-10 14:16:43,sell,38,97070,97080,99980,1092482,-0.0097,-0.535693623,-2296,0,97085.0,97085.0,97075.0,97085.0,64,203,-0.009589390461616934,-0.04387610657508834,0.39932646970460567,10.0,11.25,10.5,11.0,7.5
2019-06-10 16:57:00,sell,19,97525,97160,100060,1092759,0.0047,0.210403986,277,1,97525.0,97530.0,97520.0,97525.0,26,125,0.004532111036720399,-0.04387610657508834,0.39932646970460567,10.0,10.75,11.0,11.0,10.0
2019-06-10 17:00:01,sell,19,97525,97160,100060,1093036,0.0,-0.032808644,277,1,97540.0,97540.0,97530.0,97535.0,39,92,0.00010253781081773904,-0.04387610657508834,0.39932646970460567,10.0,10.75,11.0,11.0,10.0
2019-06-13 16:57:00,buy,9,99795,100185,97285,1093198,0.0233,1.174920802,162,1,99790.0,99795.0,99785.0,99785.0,41,148,0.023068642025939407,-0.04387610657508834,0.39932646970460567,10.0,10.75,10.0,9.0,10.0
2019-06-13 17:00:01,buy,9,99835,100185,97285,1093288,0.0004,-0.012011152,90,1,99830.0,99830.0,99820.0,99830.0,99,383,0.00045096958460690484,-0.04387610657508834,0.39932646970460567,10.0,11.0,10.5,10.0,10.0
2019-06-17 12:33:05,sell,38,98970,98980,101880,1090992,-0.0087,-0.482374212,-2296,0,99030.0,99030.0,99025.0,99025.0,48,134,-0.008063708304116998,-0.04387610657508834,0.39932646970460567,5.0,10.75,10.0,9.0,7.5
2019-06-17 14:58:16,sell,38,98860,98865,101765,1088734,-0.0011,-0.0904785,-2258,0,98905.0,98910.0,98905.0,98905.0,27,89,-0.0012118151981822772,-0.04387610657508834,0.39932646970460567,5.0,10.5,9.5,8.0,5.0
2019-06-18 16:57:00,sell,19,100265,99750,102650,1089581,0.0142,0.704612312,847,1,100265.0,100270.0,100265.0,100265.0,24,193,0.013750568727566857,-0.04387610657508834,0.39932646970460567,5.0,10.25,9.0,7.0,5.0
2019-06-18 17:00:01,sell,19,100285,99750,102650,1090504,0.0002,-0.022458643,923,1,100290.0,100295.0,100285.0,100290.0,77,273,0.00024933925098489005,-0.04387610657508834,0.39932646970460567,10.0,10.0,8.0,7.0,7.5
2019-06-25 16:57:00,buy,19,100940,102590,99690,1095674,0.0065,0.306086291,5170,1,100935.0,100940.0,100935.0,100940.0,6,6,0.006481204506929903,-0.04387610657508834,0.39932646970460567,5.0,9.5,8.0,6.0,7.5
2019-06-25 17:00:01,buy,19,100835,102590,99690,1101243,-0.001,-0.086782787,5569,1,100825.0,100830.0,100820.0,100825.0,64,183,-0.0011392906677234,-0.04387610657508834,0.39932646970460567,10.0,9.25,8.0,7.0,7.5
2019-06-27 13:35:20,buy,38,100675,100670,97770,1099005,-0.0016,-0.1151406,-2238,0,100660.0,100665.0,100645.0,100650.0,138,670,-0.0017356806347632037,-0.04387610657508834,0.39932646970460567,20.0,10.0,9.0,10.0,15.0
2019-06-27 16:57:00,sell,19,101460,100560,103460,1101315,0.0078,0.371774491,2310,1,101460.0,101460.0,101450.0,101455.0,46,144,0.007998012916045703,-0.04387610657508834,0.39932646970460567,10.0,10.0,9.0,11.0,15.0
2019-06-27 17:00:01,sell,19,101455,100560,103460,1103606,0.0,-0.035365668,2291,1,101440.0,101450.0,101440.0,101450.0,24,63,-4.928293332019122e-05,-0.04387610657508834,0.39932646970460567,10.0,9.5,9.0,11.0,10.0
2019-07-02 13:30:09,buy,38,102110,102105,99205,1101388,0.0065,0.302178085,-2218,0,102120.0,102145.0,102120.0,102140.0,417,1414,0.0068013799901429275,-0.04387610657508834,0.39932646970460567,25.0,10.5,10.5,15.0,17.5
2019-07-02 16:57:00,buy,19,101320,101580,98680,1101286,-0.0077,-0.434246728,-102,0,101315.0,101325.0,101315.0,101325.0,47,192,-0.007979244174662229,-0.04387610657508834,0.39932646970460567,10.0,10.5,11.0,15.0,17.5
2019-07-02 17:00:01,buy,19,101365,101580,98680,1101013,0.0004,-0.009763624,-273,0,101375.0,101380.0,101360.0,101365.0,114,539,0.0003947693066864051,-0.04387610657508834,0.39932646970460567,20.0,11.0,12.5,15.0,15.0
2019-07-08 16:57:00,buy,19,105115,105350,102450,1100806,0.037,1.886757139,-207,0,105110.0,105120.0,105110.0,105120.0,51,325,0.03704434469491442,-0.04387610657508834,0.39932646970460567,10.0,11.0,13.0,15.0,15.0
2019-07-08 17:00:01,buy,19,105080,105350,102450,1100732,-0.0003,-0.050085436,-74,0,105065.0,105070.0,105065.0,105065.0,46,167,-0.0005232115677321156,-0.04387610657508834,0.39932646970460567,5.0,10.25,12.5,14.0,7.5
2019-07-12 16:57:00,buy,19,104590,105890,102990,1104602,-0.0047,-0.274764296,3870,1,104585.0,104585.0,104585.0,104585.0,5,13,-0.004568600390234616,-0.04387610657508834,0.39932646970460567,0.0,10.0,12.0,9.0,2.5
2019-07-12 17:00:01,buy,19,104650,105890,102990,1108244,0.0006,-0.003042618,3642,1,104655.0,104655.0,104645.0,104650.0,21,51,0.0006215040397762585,-0.04387610657508834,0.39932646970460567,10.0,10.0,12.0,9.0,5.0
2019-07-16 16:57:00,buy,19,104185,104525,101625,1108446,-0.0044,-0.263363077,202,1,104180.0,104185.0,104180.0,104185.0,19,64,-0.004443382704252269,-0.04387610657508834,0.39932646970460567,5.0,9.75,10.5,6.0,7.5
2019-07-16 17:00:01,buy,19,104185,104525,101625,1108648,0.0,-0.032808644,202,1,104180.0,104185.0,104180.0,104180.0,36,116,-4.799155348658636e-05,-0.04387610657508834,0.39932646970460567,5.0,9.5,10.0,5.0,5.0
2019-07-18 16:57:00,sell,19,105085,104230,107130,1110787,0.0086,0.415417383,2139,1,105085.0,105090.0,105080.0,105080.0,19,148,0.008638894221539644,-0.04387610657508834,0.39932646970460567,10.0,9.5,10.0,6.0,7.5
2019-07-18 17:00:01,sell,19,105080,104230,107130,1112907,0.0,-0.035277461,2120,1,105095.0,105100.0,105095.0,105100.0,71,548,0.00019033117624666921,-0.04387610657508834,0.39932646970460567,5.0,9.25,8.0,7.0,7.5
2019-07-22 16:57:00,buy,19,104225,104570,101670,1113118,-0.0081,-0.454996568,211,1,104220.0,104225.0,104220.0,104225.0,9,38,-0.008325404376784015,-0.04387610657508834,0.39932646970460567,5.0,9.25,7.5,6.0,5.0
2019-07-22 17:00:01,buy,19,104285,104570,101670,1113101,0.0006,-0.002938377,-17,0,104270.0,104275.0,104260.0,104260.0,166,761,0.00033581194531062604,-0.04387610657508834,0.39932646970460567,15.0,9.75,7.0,8.0,10.0
2019-07-24 15:26:21,sell,38,104300,104305,107205,1110843,0.0001,-0.025345373,-2258,0,104335.0,104335.0,104330.0,104335.0,147,1081,0.0007193554575100709,-0.04387610657508834,0.39932646970460567,5.0,9.75,6.5,8.0,10.0
2019-07-25 16:57:00,buy,9,102780,104760,101860,1113867,-0.0146,-0.788977935,3024,1,102775.0,102775.0,102765.0,102770.0,27,146,-0.014999760387214262,-0.04387610657508834,0.39932646970460567,10.0,9.75,7.0,8.0,7.5
2019-07-25 17:00:01,buy,9,102835,104760,101860,1116792,0.0005,-0.005042611,2925,1,102840.0,102840.0,102835.0,102840.0,30,98,0.0006811326262527975,-0.04387610657508834,0.39932646970460567,5.0,9.75,7.5,8.0,7.5
2019-07-29 16:57:00,sell,19,103585,102850,105750,1118485,0.0073,0.345616573,1693,1,103585.0,103590.0,103585.0,103590.0,34,187,0.007292882147024504,-0.04387610657508834,0.39932646970460567,5.0,9.5,7.0,8.0,5.0
2019-07-29 17:00:01,sell,19,103685,102850,105750,1120558,0.001,0.017282724,2073,1,103680.0,103690.0,103680.0,103685.0,43,117,0.0009170769379283714,-0.04387610657508834,0.39932646970460567,10.0,9.0,7.5,7.0,7.5
2019-07-31 10:45:14,buy,38,103095,103070,100170,1118188,-0.0057,-0.328062675,-2370,0,102960.0,102970.0,102955.0,102965.0,79,266,-0.006944109562617543,-0.04387610657508834,0.39932646970460567,15.0,9.25,8.5,9.0,12.5
2019-07-31 15:00:02,buy,38,102680,102655,99755,1115818,-0.004,-0.241675846,-2370,0,102590.0,102655.0,102560.0,102645.0,1455,5103,-0.0031078521827805567,-0.04387610657508834,0.39932646970460567,95.0,13.5,17.0,26.0,55.0
2019-08-01 14:35:05,sell,38,103230,103250,106150,1113466,0.0054,0.245122098,-2352,0,103275.0,103285.0,103250.0,103265.0,402,1739,0.006040235764041112,-0.04387610657508834,0.39932646970460567,35.0,14.0,20.0,32.0,65.0
2019-08-12 11:25:10,buy,38,102005,101985,99085,1111154,-0.0119,-0.648538082,-2312,0,101975.0,101980.0,101965.0,101970.0,158,427,-0.012540551009538567,-0.04387610657508834,0.39932646970460567,15.0,14.25,21.0,34.0,25.0
2019-08-19 16:57:00,buy,9,100045,101465,98565,1113170,-0.0192,-1.029806829,2016,1,100040.0,100040.0,100035.0,100035.0,43,100,-0.018976169461606355,-0.04387610657508834,0.39932646970460567,5.0,13.5,20.0,33.0,10.0
2019-08-19 17:00:01,buy,9,100000,101465,98565,1115267,-0.0004,-0.056147355,2097,1,99960.0,99965.0,99950.0,99950.0,149,479,-0.000849702604088569,-0.04387610657508834,0.39932646970460567,15.0,13.75,21.0,33.0,10.0
2019-08-21 10:39:04,buy,38,100740,100735,97835,1113029,0.0074,0.351156213,-2238,0,100730.0,100735.0,100710.0,100715.0,261,731,0.0076538269134567285,-0.04387610657508834,0.39932646970460567,25.0,14.75,22.5,19.0,20.0
2019-08-21 16:57:00,sell,19,102090,100655,103555,1117372,0.0134,0.662522335,4343,1,102090.0,102095.0,102085.0,102090.0,80,355,0.013652385444074865,-0.04387610657508834,0.39932646970460567,10.0,15.25,23.0,14.0,17.5
2019-08-21 17:00:01,sell,19,102085,100655,103555,1121696,0.0,-0.035349889,4324,1,102085.0,102090.0,102070.0,102075.0,100,316,-0.00014692918013517486,-0.04387610657508834,0.39932646970460567,20.0,15.75,24.5,15.0,15.0
2019-09-02 15:17:20,buy,38,101920,101915,99015,1119458,-0.0016,-0.11667384,-2238,0,101800.0,101800.0,101795.0,101795.0,6,18,-0.0027430810678422727,-0.04387610657508834,0.39932646970460567,5.0,15.75,24.0,15.0,12.5
2019-09-03 11:06:14,sell,38,101420,101435,104335,1117124,-0.0049,-0.287357029,-2334,0,101560.0,101565.0,101530.0,101535.0,162,1069,-0.0025541529544673117,-0.04387610657508834,0.39932646970460567,35.0,17.25,26.0,19.0,20.0
2019-09-03 15:51:14,sell,38,100510,100520,103420,1114828,-0.009,-0.498370663,-2296,0,100570.0,100575.0,100565.0,100570.0,86,275,-0.009504111882602058,-0.04387610657508834,0.39932646970460567,10.0,17.25,17.5,16.0,22.5
2019-09-04 16:01:10,buy,38,101600,101580,98680,1112516,0.0108,0.529891443,-2312,0,101555.0,101560.0,101550.0,101555.0,81,282,0.00979417321268768,-0.04387610657508834,0.39932646970460567,10.0,17.5,15.0,16.0,10.0
2019-09-05 15:07:10,sell,38,103025,102645,105545,1113244,0.014,0.694939176,728,1,103090.0,103100.0,103090.0,103090.0,70,259,0.015114962335680174,-0.04387610657508834,0.39932646970460567,10.0,17.75,14.5,14.0,10.0
2019-09-09 13:25:32,sell,38,104245,104245,107145,1111024,0.0118,0.581627796,-2220,0,104275.0,104275.0,104270.0,104275.0,36,173,0.011494810359879717,-0.04387610657508834,0.39932646970460567,5.0,17.25,14.5,14.0,7.5
2019-09-09 16:57:00,buy,19,103735,103790,100890,1110133,-0.0049,-0.286657201,-891,0,103730.0,103740.0,103725.0,103740.0,67,282,-0.005130664109326301,-0.04387610657508834,0.39932646970460567,15.0,17.75,14.5,10.0,10.0
2019-09-09 17:00:01,buy,19,103760,103790,100890,1109147,0.0002,-0.02030391,-986,0,103755.0,103760.0,103750.0,103750.0,81,362,9.63948332369385e-05,-0.04387610657508834,0.39932646970460567,10.0,17.75,13.0,10.0,12.5
2019-09-11 10:46:03,buy,38,104200,104195,101295,1107089,0.0042,0.187221646,-2058,0,104160.0,104165.0,104155.0,104165.0,143,444,0.004,-0.04387610657508834,0.39932646970460567,10.0,18.0,13.0,10.0,10.0
2019-09-11 12:14:16,sell,38,104195,104200,107100,1104831,0.0,-0.03529843,-2258,0,104200.0,104205.0,104195.0,104205.0,214,585,0.00038400614409830555,-0.04387610657508834,0.39932646970460567,10.0,18.25,12.0,10.0,10.0
2019-09-11 16:57:00,buy,19,104035,104310,101410,1104786,-0.0015,-0.112485623,-45,0,104030.0,104035.0,104025.0,104035.0,51,217,-0.0016313996449306655,-0.04387610657508834,0.39932646970460567,10.0,18.25,12.5,11.0,10.0
2019-09-11 17:00:01,buy,19,104040,104310,101410,1104722,0.0,-0.030314909,-64,0,104030.0,104035.0,104025.0,104035.0,77,357,0.0,-0.04387610657508834,0.39932646970460567,10.0,18.0,10.0,10.0,10.0
2019-09-13 16:57:00,buy,19,103825,105185,102285,1108810,-0.0021,-0.140034092,4088,1,103820.0,103835.0,103820.0,103825.0,54,292,-0.0020185514490315758,-0.04387610657508834,0.39932646970460567,15.0,14.0,10.5,11.0,12.5
2019-09-13 17:00:01,buy,19,103840,105185,102285,1112841,0.0001,-0.025312307,4031,1,103825.0,103835.0,103825.0,103830.0,70,301,4.815795810257645e-05,-0.04387610657508834,0.39932646970460567,10.0,12.75,10.5,11.0,12.5
2019-09-17 16:57:00,sell,19,104930,103495,106395,1117194,0.0105,0.511846457,4353,1,104930.0,104935.0,104930.0,104935.0,17,40,0.010642396224597901,-0.04387610657508834,0.39932646970460567,5.0,12.25,10.0,10.0,7.5
2019-09-17 17:00:01,sell,19,104955,103495,106395,1121642,0.0002,-0.02044632,4448,1,104975.0,104975.0,104955.0,104965.0,145,815,0.00028589126602182304,-0.04387610657508834,0.39932646970460567,20.0,13.0,11.5,12.0,12.5
2019-09-19 11:10:14,sell,38,105835,105835,108735,1119442,0.0084,0.40224148,-2200,0,105870.0,105880.0,105865.0,105875.0,160,449,0.008669556518839614,-0.04387610657508834,0.39932646970460567,15.0,13.0,11.5,13.0,17.5
2019-09-19 16:57:00,buy,19,104745,105775,102875,1122256,-0.0103,-0.567196943,2814,1,104740.0,104740.0,104730.0,104735.0,40,140,-0.01076741440377804,-0.04387610657508834,0.39932646970460567,10.0,12.25,11.5,12.0,12.5
2019-09-19 17:00:01,buy,19,104660,105775,102875,1125393,-0.0008,-0.074914779,3137,1,104675.0,104680.0,104665.0,104670.0,117,573,-0.0006206139303957608,-0.04387610657508834,0.39932646970460567,15.0,12.5,12.0,13.0,12.5
2019-09-24 16:57:00,buy,19,104075,104985,102085,1127751,-0.0056,-0.322833281,2358,1,104070.0,104070.0,104070.0,104070.0,7,18,-0.005732301519059902,-0.04387610657508834,0.39932646970460567,0.0,11.5,11.0,12.0,7.5
2019-09-24 17:00:01,buy,19,104095,104985,102085,1130033,0.0002,-0.022837538,2282,1,104095.0,104100.0,104090.0,104095.0,109,614,0.00024022292687614106,-0.04387610657508834,0.39932646970460567,10.0,11.75,11.0,10.0,5.0
2019-09-26 16:57:00,sell,9,105515,104695,107595,1130969,0.0136,0.675003862,936,1,105515.0,105520.0,105515.0,105515.0,33,118,0.013641385273067871,-0.04387610657508834,0.39932646970460567,5.0,10.25,10.5,8.0,7.5
2019-09-26 17:00:01,sell,9,105575,104695,107595,1132013,0.0006,-0.003303563,1044,1,105580.0,105585.0,105575.0,105585.0,72,298,0.0006634127849120978,-0.04387610657508834,0.39932646970460567,10.0,10.25,10.0,8.0,7.5
2019-09-30 15:45:21,buy,38,105370,105365,102465,1129775,-0.0019,-0.133560377,-2238,0,105350.0,105355.0,105350.0,105350.0,57,342,-0.002225694937727897,-0.04387610657508834,0.39932646970460567,5.0,10.0,9.5,6.0,7.5
2019-10-01 16:57:00,buy,19,104205,104680,101780,1130500,-0.0111,-0.606487313,725,1,104200.0,104200.0,104195.0,104195.0,46,216,-0.010963455149501661,-0.04387610657508834,0.39932646970460567,5.0,9.75,9.5,7.0,5.0
2019-10-01 17:00:01,buy,19,104170,104680,101780,1131358,-0.0003,-0.05023631,858,1,104165.0,104170.0,104160.0,104165.0,132,436,-0.000287921685301598,-0.04387610657508834,0.39932646970460567,10.0,10.0,8.5,7.0,7.5
2019-10-04 12:08:21,buy,38,101580,101575,98675,1129140,-0.0249,-1.32288928,-2218,0,101570.0,101575.0,101565.0,101565.0,65,193,-0.02496039936638986,-0.04387610657508834,0.39932646970460567,10.0,9.75,8.0,8.0,10.0
2019-10-04 13:27:43,buy,38,101550,101535,98635,1126826,-0.0003,-0.048132667,-2314,0,101515.0,101520.0,101515.0,101520.0,28,139,-0.00044306601683650863,-0.04387610657508834,0.39932646970460567,5.0,9.5,7.5,7.0,7.5
2019-10-04 16:57:00,sell,19,102740,101780,104680,1129364,0.0117,0.575223852,2538,1,102740.0,102745.0,102730.0,102735.0,305,1995,0.011968085106382979,-0.04387610657508834,0.39932646970460567,15.0,9.75,7.5,9.0,10.0
2019-10-04 17:00:01,sell,19,102635,101780,104680,1131503,-0.001,-0.085837162,2139,1,102630.0,102630.0,102615.0,102625.0,167,643,-0.0010707159195989682,-0.04387610657508834,0.39932646970460567,15.0,10.0,9.0,11.0,15.0
2019-10-08 12:33:16,sell,38,101115,101120,104020,1129245,-0.0148,-0.801244919,-2258,0,101100.0,101105.0,101095.0,101095.0,89,361,-0.014908647990255786,-0.04387610657508834,0.39932646970460567,10.0,10.0,9.0,11.0,12.5
2019-10-09 16:57:00,sell,19,101350,100815,103715,1130178,0.0023,0.087781561,933,1,101350.0,101355.0,101350.0,101350.0,40,166,0.002522379939660715,-0.04387610657508834,0.39932646970460567,5.0,9.75,9.0,10.0,7.5
2019-10-09 17:00:01,sell,19,101355,100815,103715,1131130,0.0,-0.030248844,952,1,101325.0,101330.0,101315.0,101315.0,104,400,-0.0003453379378391712,-0.04387610657508834,0.39932646970460567,15.0,9.75,9.5,12.0,10.0
2019-10-15 16:22:16,sell,38,104630,104635,107535,1128892,0.0323,1.643777541,-2238,0,104660.0,104665.0,104660.0,104665.0,5,10,0.033065192715787395,-0.04387610657508834,0.39932646970460567,5.0,9.5,9.5,10.0,10.0
2019-10-16 10:41:08,buy,38,104845,104840,101940,1126694,0.0021,0.07381217,-2198,0,104810.0,104820.0,104805.0,104805.0,125,542,0.0013376009172120576,-0.04387610657508834,0.39932646970460567,15.0,10.0,10.5,10.0,10.0
2019-10-16 13:59:32,buy,38,105095,105090,102190,1124456,0.0024,0.090914812,-2238,0,105095.0,105095.0,105085.0,105085.0,27,71,0.0026716282620104005,-0.04387610657508834,0.39932646970460567,10.0,9.5,10.5,10.0,12.5
2019-10-16 16:57:00,sell,19,106240,105075,107975,1127783,0.0109,0.532496828,3327,1,106240.0,106240.0,106235.0,106240.0,7,17,0.010991102440881192,-0.04387610657508834,0.39932646970460567,5.0,9.0,10.0,10.0,7.5
2019-10-16 17:00:01,sell,19,106240,105075,107975,1131110,0.0,-0.032808644,3327,1,106235.0,106240.0,106230.0,106235.0,43,148,-4.7063253012048195e-05,-0.04387610657508834,0.39932646970460567,10.0,9.0,10.5,9.0,7.5
2019-10-18 11:35:13,sell,38,105980,105990,108890,1128834,-0.0024,-0.159791486,-2276,0,106005.0,106020.0,106000.0,106020.0,443,1435,-0.0020238151268414366,-0.04387610657508834,0.39932646970460567,20.0,9.25,11.0,12.0,15.0
2019-10-18 14:21:21,buy,38,105715,105705,102805,1126558,-0.0025,-0.16255098,-2276,0,105615.0,105620.0,105615.0,105615.0,14,64,-0.0038200339558573855,-0.04387610657508834,0.39932646970460567,5.0,9.5,10.0,10.0,12.5
2019-10-21 12:01:21,buy,38,105815,105805,102905,1124322,0.0009,0.016273457,-2236,0,105715.0,105720.0,105715.0,105720.0,21,53,0.0009941769634995029,-0.04387610657508834,0.39932646970460567,5.0,9.25,9.5,9.0,5.0
2019-10-21 12:54:10,buy,38,105825,105810,102910,1122028,0.0001,-0.027905072,-2294,0,105770.0,105770.0,105760.0,105760.0,130,454,0.00037835792659856227,-0.04387610657508834,0.39932646970460567,10.0,9.5,10.0,10.0,7.5
2019-10-21 16:57:00,sell,19,106665,105865,108765,1123958,0.0079,0.379052448,1930,1,106665.0,106665.0,106660.0,106665.0,30,75,0.008557110438729199,-0.04387610657508834,0.39932646970460567,5.0,9.25,9.0,9.0,7.5
2019-10-21 17:00:01,sell,19,106685,105865,108765,1125964,0.0002,-0.023079652,2006,1,106685.0,106690.0,106680.0,106685.0,68,241,0.00018750292973327708,-0.04387610657508834,0.39932646970460567,10.0,9.5,9.5,7.0,7.5
2019-10-24 16:57:00,buy,19,107815,108425,105525,1127182,0.0106,0.516776316,1218,1,107810.0,107810.0,107805.0,107810.0,23,65,0.010545062567371232,-0.04387610657508834,0.39932646970460567,5.0,9.5,8.5,7.0,7.5
2019-10-24 17:00:01,buy,19,107755,108425,105525,1128628,-0.0006,-0.061684297,1446,1,107765.0,107785.0,107755.0,107775.0,279,1176,-0.00032464520916427046,-0.04387610657508834,0.39932646970460567,30.0,10.5,10.5,12.0,17.5
2019-10-28 16:57:00,sell,19,108870,108040,110940,1130672,0.0103,0.504096041,2044,1,108870.0,108870.0,108855.0,108860.0,191,674,0.010067269774994201,-0.04387610657508834,0.39932646970460567,15.0,10.75,11.5,13.0,22.5
2019-10-28 17:00:01,sell,19,108820,108040,110940,1132526,-0.0005,-0.056638506,1854,1,108820.0,108825.0,108815.0,108820.0,64,261,-0.00036744442403086535,-0.04387610657508834,0.39932646970460567,10.0,11.0,11.5,14.0,12.5
2019-10-30 12:08:43,buy,38,107675,107670,104770,1130288,-0.0105,-0.578763234,-2238,0,107645.0,107645.0,107640.0,107645.0,49,223,-0.010797647491269987,-0.04387610657508834,0.39932646970460567,5.0,10.5,10.0,13.0,7.5
2019-10-30 16:57:00,sell,19,108965,107630,110530,1134281,0.012,0.588825108,3993,1,108965.0,108965.0,108960.0,108965.0,42,158,0.012262529611222072,-0.04387610657508834,0.39932646970460567,5.0,10.0,10.0,13.0,5.0
2019-10-30 17:00:01,sell,19,109030,107630,110530,1138521,0.0006,-0.001856831,4240,1,109025.0,109025.0,109020.0,109025.0,43,155,0.0005506355251686322,-0.04387610657508834,0.39932646970460567,5.0,9.75,10.0,8.0,5.0
2019-11-01 15:24:08,sell,38,108410,108450,111350,1136057,-0.0057,-0.327865312,-2464,0,108520.0,108535.0,108520.0,108530.0,88,419,-0.004540243063517542,-0.04387610657508834,0.39932646970460567,15.0,10.25,10.5,8.0,10.0
2019-11-05 12:00:13,buy,38,109530,109525,106625,1133839,0.0103,0.503245226,-2218,0,109515.0,109540.0,109515.0,109535.0,650,2274,0.009260112411314844,-0.04387610657508834,0.39932646970460567,25.0,10.75,12.5,11.0,20.0
2019-11-05 16:57:00,sell,19,109125,108975,111875,1133299,-0.0037,-0.22466743,-540,0,109125.0,109125.0,109125.0,109125.0,10,55,-0.0037430958141233396,-0.04387610657508834,0.39932646970460567,0.0,10.5,11.5,10.0,12.5
2019-11-05 17:00:01,sell,19,109015,108975,111875,1132341,-0.001,-0.085111834,-958,0,109025.0,109025.0,109015.0,109020.0,92,376,-0.0009621993127147767,-0.04387610657508834,0.39932646970460567,10.0,10.25,12.0,11.0,5.0
2019-11-08 11:59:06,sell,38,108595,108605,111505,1130045,-0.0039,-0.232713244,-2296,0,108940.0,108940.0,108885.0,108890.0,723,2587,-0.001192441753806641,-0.04387610657508834,0.39932646970460567,55.0,12.5,14.5,21.0,32.5
2019-11-08 16:57:00,buy,19,107775,109265,106365,1134607,-0.0076,-0.424608055,4562,1,107770.0,107770.0,107760.0,107765.0,37,130,-0.010331527229313986,-0.04387610657508834,0.39932646970460567,10.0,12.75,14.0,20.0,32.5
2019-11-08 17:00:01,buy,19,107920,109265,106365,1138618,0.0013,0.037000085,4011,1,107920.0,107920.0,107910.0,107920.0,81,342,0.0014383148517607758,-0.04387610657508834,0.39932646970460567,10.0,12.75,14.0,17.0,10.0
2019-11-12 16:57:00,buy,19,107165,107895,104995,1140292,-0.007,-0.395807095,1674,1,107160.0,107165.0,107155.0,107165.0,26,67,-0.0069959229058561894,-0.04387610657508834,0.39932646970460567,10.0,12.25,14.5,19.0,10.0
2019-11-12 17:00:01,buy,19,107255,107895,104995,1141624,0.0008,0.010767551,1332,1,107260.0,107280.0,107255.0,107280.0,156,725,0.001073111556944898,-0.04387610657508834,0.39932646970460567,25.0,13.25,16.5,22.0,17.5
2019-11-14 16:57:00,sell,19,106965,106350,109250,1142851,-0.0027,-0.173103002,1227,1,106965.0,106970.0,106965.0,106965.0,13,29,-0.002936241610738255,-0.04387610657508834,0.39932646970460567,5.0,13.25,16.5,12.0,15.0
2019-11-14 17:00:01,sell,19,106965,106350,109250,1144078,0.0,-0.032808644,1227,1,106960.0,106960.0,106955.0,106960.0,25,71,-4.674426214182209e-05,-0.04387610657508834,0.39932646970460567,5.0,13.0,15.5,11.0,5.0
2019-11-19 16:57:00,buy,19,106065,107190,104290,1147253,-0.0084,-0.469385361,3175,1,106060.0,106065.0,106055.0,106060.0,39,209,-0.008414360508601346,-0.04387610657508834,0.39932646970460567,10.0,13.25,14.0,11.0,7.5
2019-11-19 17:00:01,buy,19,106020,107190,104290,1150599,-0.0004,-0.054822705,3346,1,106020.0,106020.0,106015.0,106015.0,44,158,-0.00042428813878936454,-0.04387610657508834,0.39932646970460567,5.0,13.0,14.5,10.0,7.5
2019-11-25 16:57:00,sell,19,108790,108470,111370,1150705,0.0261,1.322854303,106,1,108790.0,108795.0,108790.0,108795.0,19,66,0.026222704334292316,-0.04387610657508834,0.39932646970460567,5.0,13.0,14.0,6.0,5.0
2019-11-25 17:00:01,sell,19,108830,108470,111370,1150963,0.0004,-0.013730735,258,1,108830.0,108830.0,108820.0,108820.0,111,414,0.00022978997196562343,-0.04387610657508834,0.39932646970460567,10.0,12.0,9.5,7.0,7.5
2019-11-28 16:57:00,sell,19,108520,107715,110615,1152942,-0.0028,-0.180608095,1979,1,108520.0,108520.0,108515.0,108520.0,20,53,-0.0027568461679838264,-0.04387610657508834,0.39932646970460567,5.0,11.5,9.0,7.0,7.5
2019-11-28 17:00:01,sell,19,108530,107715,110615,1154959,0.0001,-0.0280273,2017,1,108525.0,108525.0,108520.0,108520.0,20,58,0.0,-0.04387610657508834,0.39932646970460567,5.0,11.25,8.5,6.0,5.0
2019-12-02 16:57:00,sell,19,109335,108910,111810,1155474,0.0074,0.352054067,515,1,109335.0,109335.0,109330.0,109330.0,50,176,0.007464061924069296,-0.04387610657508834,0.39932646970460567,5.0,11.25,8.0,6.0,5.0
2019-12-02 17:00:01,sell,19,109320,108910,111810,1155932,-0.0001,-0.039927198,458,1,109330.0,109335.0,109325.0,109330.0,169,551,0.0,-0.04387610657508834,0.39932646970460567,10.0,11.5,6.5,7.0,7.5
2019-12-04 16:57:00,sell,19,110305,109520,112420,1157835,0.009,0.434707233,1903,1,110305.0,110310.0,110305.0,110305.0,18,85,0.0089179548156956,-0.04387610657508834,0.39932646970460567,5.0,11.5,6.5,6.0,7.5
2019-12-04 17:00:01,sell,19,110290,109520,112420,1159681,-0.0001,-0.039864599,1846,1,110285.0,110295.0,110285.0,110290.0,59,275,-0.00013598658265717782,-0.04387610657508834,0.39932646970460567,10.0,11.25,7.0,7.0,7.5
2019-12-06 16:57:00,sell,9,111340,110860,113760,1160005,0.0095,0.461175398,324,1,111340.0,111345.0,111340.0,111345.0,4,15,0.009565690452443558,-0.04387610657508834,0.39932646970460567,5.0,10.25,6.5,7.0,7.5
2019-12-06 17:00:01,sell,9,111335,110860,113760,1160320,0.0,-0.035138765,315,1,111335.0,111350.0,111335.0,111350.0,99,436,4.490547397727783e-05,-0.04387610657508834,0.39932646970460567,15.0,11.0,7.5,9.0,10.0
2019-12-10 15:16:21,buy,38,110605,110590,107690,1158026,-0.0066,-0.373021643,-2294,0,110545.0,110550.0,110545.0,110545.0,36,203,-0.007229456668163449,-0.04387610657508834,0.39932646970460567,5.0,10.75,7.5,8.0,10.0
2019-12-11 14:00:02,sell,38,110885,110885,113785,1155806,0.0025,0.098545273,-2220,0,110885.0,110895.0,110885.0,110895.0,476,2313,0.0031661314396851962,-0.04387610657508834,0.39932646970460567,10.0,8.5,7.5,9.0,7.5
2019-12-12 16:57:00,sell,19,112345,111545,114445,1157746,0.0132,0.650378699,1940,1,112345.0,112350.0,112345.0,112350.0,7,36,0.013120519410252942,-0.04387610657508834,0.39932646970460567,5.0,8.25,7.5,8.0,7.5
2019-12-12 17:00:01,sell,19,112375,111545,114445,1159800,0.0003,-0.018952982,2054,1,112385.0,112400.0,112380.0,112385.0,566,2526,0.00031152647975077883,-0.04387610657508834,0.39932646970460567,20.0,8.75,9.0,11.0,12.5
2019-12-16 15:44:10,sell,38,112970,112985,115885,1157486,0.0053,0.241921946,-2314,0,113035.0,113040.0,113020.0,113025.0,250,1270,0.005694710148151444,-0.04387610657508834,0.39932646970460567,20.0,9.25,10.5,12.0,20.0
2019-12-17 16:57:00,sell,19,112450,112145,115045,1157535,-0.0046,-0.271644744,49,1,112450.0,112455.0,112450.0,112450.0,32,137,-0.0050873700508737,-0.04387610657508834,0.39932646970460567,5.0,8.25,10.0,12.0,12.5
2019-12-17 17:00:01,sell,19,112475,112145,115045,1157679,0.0002,-0.02127304,144,1,112480.0,112490.0,112480.0,112490.0,117,748,0.0003557136505113384,-0.04387610657508834,0.39932646970460567,10.0,8.5,10.5,12.0,7.5
2019-12-20 14:00:19,sell,38,115395,115395,118295,1155459,0.026,1.314250321,-2220,0,115440.0,115445.0,115430.0,115430.0,63,306,0.02613565650280025,-0.04387610657508834,0.39932646970460567,15.0,9.0,11.0,14.0,12.5
2019-12-23 16:57:00,buy,19,115875,116010,113110,1154872,0.0042,0.183022446,-587,0,115870.0,115870.0,115865.0,115865.0,6,20,0.0037685177163648965,-0.04387610657508834,0.39932646970460567,5.0,8.75,11.0,11.0,10.0
2019-12-23 17:00:01,buy,19,115915,116010,113110,1154133,0.0003,-0.014897224,-739,0,115910.0,115915.0,115910.0,115910.0,36,78,0.0003883830319768696,-0.04387610657508834,0.39932646970460567,5.0,8.75,10.0,8.0,5.0
2019-12-30 11:39:10,sell,38,117285,117295,120195,1151857,0.0118,0.580445773,-2276,0,117340.0,117340.0,117335.0,117340.0,75,253,0.012337158139936157,-0.04387610657508834,0.39932646970460567,5.0,8.75,10.0,8.0,5.0
2019-12-30 16:57:00,buy,19,116595,117100,114200,1152686,-0.0059,-0.338066166,829,1,116590.0,116595.0,116590.0,116590.0,14,31,-0.006391682290778933,-0.04387610657508834,0.39932646970460567,5.0,8.5,9.5,7.0,5.0
2019-12-30 17:00:01,buy,19,116575,117100,114200,1153591,-0.0002,-0.04170905,905,1,116570.0,116570.0,116560.0,116565.0,37,86,-0.0002144266232095377,-0.04387610657508834,0.39932646970460567,10.0,8.75,10.0,6.0,7.5
2020-01-06 12:10:10,buy,38,117265,117260,114360,1151413,0.0059,0.27430805,-2178,0,117220.0,117225.0,117210.0,117215.0,298,1101,0.005576287908034144,-0.04387610657508834,0.39932646970460567,15.0,9.25,9.5,8.0,12.5
2020-01-07 15:18:20,buy,38,117225,117220,114320,1149215,-0.0003,-0.05050775,-2198,0,117210.0,117215.0,117205.0,117205.0,109,350,-8.531331314251589e-05,-0.04387610657508834,0.39932646970460567,10.0,9.5,8.5,9.0,12.5
2020-01-08 13:38:07,buy,18,116985,117380,114480,1149557,-0.002,-0.139039518,342,1,116920.0,116940.0,116920.0,116935.0,167,791,-0.0023036559873725526,-0.04387610657508834,0.39932646970460567,20.0,10.0,10.0,12.0,15.0
2020-01-08 15:46:20,sell,38,116870,116885,119785,1147283,-0.001,-0.083815366,-2274,0,116955.0,116960.0,116955.0,116960.0,26,77,0.00021379398811305426,-0.04387610657508834,0.39932646970460567,5.0,10.0,9.5,12.0,12.5
2020-01-09 10:56:01,sell,38,116880,116880,119780,1145163,0.0001,-0.028368912,-2120,0,116900.0,116910.0,116895.0,116900.0,320,1066,-0.0005129958960328317,-0.04387610657508834,0.39932646970460567,15.0,10.25,9.5,13.0,10.0
2020-01-09 13:05:21,buy,38,116750,116745,113845,1142985,-0.0011,-0.090520216,-2178,0,116715.0,116720.0,116710.0,116715.0,65,215,-0.0015825491873396064,-0.04387610657508834,0.39932646970460567,10.0,10.5,10.0,12.0,12.5
2020-01-09 16:57:00,buy,19,116355,116595,113695,1142797,-0.0034,-0.208358292,-188,0,116350.0,116350.0,116340.0,116345.0,70,299,-0.0031701152379728396,-0.04387610657508834,0.39932646970460567,10.0,10.25,10.5,12.0,10.0
2020-01-09 17:00:01,buy,19,116295,116595,113695,1142837,-0.0005,-0.059564937,40,1,116275.0,116290.0,116275.0,116290.0,86,439,-0.0004727319609781254,-0.04387610657508834,0.39932646970460567,15.0,10.75,11.5,11.0,12.5
2020-01-13 11:20:05,sell,38,116460,116470,119370,1140561,0.0014,0.040809126,-2276,0,116805.0,116810.0,116805.0,116810.0,22,69,0.004471579671510878,-0.04387610657508834,0.39932646970460567,5.0,10.5,11.5,11.0,10.0
2020-01-13 16:57:00,sell,19,117700,116880,119780,1142567,0.0106,0.519656212,2006,1,117700.0,117700.0,117685.0,117685.0,81,615,0.007490797020803013,-0.04387610657508834,0.39932646970460567,15.0,11.0,12.0,11.0,10.0
2020-01-13 17:00:01,sell,19,117625,116880,119780,1144288,-0.0006,-0.065871819,1721,1,117630.0,117635.0,117625.0,117630.0,81,340,-0.00046734927985724603,-0.04387610657508834,0.39932646970460567,10.0,10.5,11.5,11.0,12.5
2020-01-15 16:10:13,buy,38,116965,116960,114060,1142050,-0.0056,-0.323950104,-2238,0,116955.0,116965.0,116955.0,116955.0,54,314,-0.005738332058148432,-0.04387610657508834,0.39932646970460567,10.0,10.0,11.5,11.0,10.0
2020-01-16 16:57:00,buy,19,116765,117340,114440,1143135,-0.0017,-0.121531155,1085,1,116760.0,116765.0,116760.0,116765.0,104,493,-0.0016245564533367534,-0.04387610657508834,0.39932646970460567,5.0,10.0,10.0,9.0,7.5
2020-01-16 17:00:01,buy,19,116750,117340,114440,1144277,-0.0001,-0.03947423,1142,1,116745.0,116750.0,116740.0,116740.0,65,170,-0.00021410525414293667,-0.04387610657508834,0.39932646970460567,10.0,10.0,10.5,10.0,7.5
2020-01-21 11:41:02,sell,38,118505,118505,121405,1142137,0.015,0.747165109,-2140,0,118530.0,118540.0,118525.0,118540.0,143,788,0.015418879561418537,-0.04387610657508834,0.39932646970460567,15.0,10.0,10.5,10.0,12.5
2020-01-21 16:57:00,buy,19,117845,117900,115000,1141276,-0.0056,-0.321788132,-861,0,117840.0,117845.0,117840.0,117845.0,23,65,-0.005862999831280581,-0.04387610657508834,0.39932646970460567,5.0,10.0,10.0,9.0,10.0
2020-01-21 17:00:01,buy,19,117805,117900,115000,1140567,-0.0003,-0.05042064,-709,0,117800.0,117805.0,117795.0,117795.0,61,294,-0.00042428613857185284,-0.04387610657508834,0.39932646970460567,10.0,10.25,10.0,9.0,7.5
2020-01-23 16:57:00,sell,19,119545,117485,120385,1147285,0.0148,0.733573331,6718,1,119545.0,119550.0,119540.0,119545.0,101,429,0.01485631817988879,-0.04387610657508834,0.39932646970460567,10.0,10.5,9.5,10.0,10.0
2020-01-23 17:00:01,sell,19,119585,117485,120385,1154155,0.0003,-0.0154471,6870,1,119590.0,119595.0,119590.0,119590.0,24,78,0.0003764272867957673,-0.04387610657508834,0.39932646970460567,5.0,10.5,9.5,9.0,7.5
2020-02-03 11:00:14,buy,38,114020,113995,111095,1151765,-0.0465,-2.447425441,-2390,0,113920.0,113920.0,113915.0,113920.0,37,101,-0.04741199096914458,-0.04387610657508834,0.39932646970460567,5.0,10.25,8.5,7.0,5.0
2020-02-03 16:57:00,sell,19,115220,114470,117370,1153515,0.0105,0.513276003,1750,1,115220.0,115220.0,115215.0,115220.0,55,267,0.011411516853932584,-0.04387610657508834,0.39932646970460567,5.0,9.75,8.0,7.0,5.0
2020-02-03 17:00:01,sell,19,115225,114470,117370,1155284,0.0,-0.030556988,1769,1,115225.0,115225.0,115215.0,115220.0,44,308,0.0,-0.04387610657508834,0.39932646970460567,10.0,9.75,8.0,7.0,7.5
2020-02-06 16:57:00,buy,9,114840,116960,114060,1158560,-0.0033,-0.206178572,3276,1,114835.0,114840.0,114830.0,114840.0,59,300,-0.0032980385349765666,-0.04387610657508834,0.39932646970460567,10.0,9.25,8.5,7.0,10.0
2020-02-06 17:00:01,buy,9,114795,116960,114060,1161917,-0.0004,-0.053140596,3357,1,114790.0,114795.0,114775.0,114790.0,175,765,-0.0004353883664228492,-0.04387610657508834,0.39932646970460567,20.0,10.0,9.5,10.0,15.0
2020-02-14 16:57:00,buy,19,115065,116215,113315,1165187,0.0024,0.089230893,3270,1,115060.0,115065.0,115045.0,115045.0,144,787,0.002221447861311961,-0.04387610657508834,0.39932646970460567,20.0,10.25,10.0,13.0,20.0
2020-02-14 17:00:01,buy,19,115030,116215,113315,1168590,-0.0003,-0.048591462,3403,1,115020.0,115025.0,115020.0,115020.0,24,75,-0.00021730627145899432,-0.04387610657508834,0.39932646970460567,5.0,10.0,10.0,13.0,12.5
2020-02-18 10:42:08,sell,38,114965,114980,117880,1166256,-0.0006,-0.06212851,-2334,0,115050.0,115055.0,115050.0,115050.0,82,475,0.0002608242044861763,-0.04387610657508834,0.39932646970460567,5.0,9.75,9.5,12.0,5.0
2020-02-18 12:37:10,sell,38,114710,114710,117610,1164096,-0.0022,-0.14789777,-2160,0,114750.0,114755.0,114750.0,114755.0,64,318,-0.002564102564102564,-0.04387610657508834,0.39932646970460567,5.0,9.25,9.0,11.0,5.0
2020-02-18 16:18:07,buy,38,114720,114715,111815,1161858,0.0001,-0.028285311,-2238,0,114705.0,114720.0,114705.0,114715.0,334,1804,-0.00034856868981743717,-0.04387610657508834,0.39932646970460567,15.0,9.75,10.0,10.0,10.0
2020-02-19 16:57:00,sell,19,116990,115735,118635,1165537,0.0198,0.993898244,3679,1,116990.0,116990.0,116985.0,116990.0,14,27,0.019831756962908075,-0.04387610657508834,0.39932646970460567,5.0,9.25,10.0,7.0,10.0
2020-02-19 17:00:01,sell,19,117010,115735,118635,1169292,0.0002,-0.023938288,3755,1,117020.0,117025.0,117020.0,117025.0,30,81,0.0002991708693050688,-0.04387610657508834,0.39932646970460567,5.0,9.0,10.0,7.0,5.0
2020-03-31 12:01:10,sell,38,74670,74680,77580,1167116,-0.3618,-18.8081409,-2176,0,74750.0,74750.0,74725.0,74730.0,163,625,-0.36141850032044437,-0.04387610657508834,0.39932646970460567,25.0,9.75,11.5,11.0,15.0
2020-03-31 16:20:06,buy,19,72440,75240,72340,1176686,-0.0299,-1.582404579,9570,1,72875.0,72910.0,72865.0,72900.0,509,1291,-0.02448815736651947,-0.04387610657508834,0.39932646970460567,45.0,11.75,15.0,19.0,35.0
2020-03-31 16:20:07,buy,19,72280,75240,72340,1186864,-0.0022,-0.147413045,10178,1,72900.0,72915.0,72885.0,72885.0,249,577,-0.00020576131687242798,-0.04387610657508834,0.39932646970460567,30.0,12.75,16.0,22.0,37.5
2020-04-17 15:56:10,buy,38,78525,78520,75620,1184626,0.0864,4.450246239,-2238,0,78390.0,78395.0,78385.0,78395.0,89,389,0.07559854565411264,-0.04387610657508834,0.39932646970460567,10.0,12.5,15.0,23.0,20.0
2020-05-08 15:14:06,buy,38,80055,80050,77150,1182388,0.0195,0.978172936,-2238,0,79930.0,79930.0,79925.0,79930.0,50,207,0.019580330378212895,-0.04387610657508834,0.39932646970460567,5.0,12.5,15.0,23.0,7.5
2020-05-11 16:57:00,buy,19,79145,80380,77480,1185981,-0.0114,-0.622619398,3593,1,79140.0,79145.0,79130.0,79135.0,381,1176,-0.009946202927561617,-0.04387610657508834,0.39932646970460567,15.0,12.75,16.0,21.0,10.0
2020-05-11 17:00:01,buy,19,79020,80380,77480,1190049,-0.0016,-0.114758139,4068,1,79020.0,79050.0,79020.0,79045.0,305,1072,-0.001137297024072787,-0.04387610657508834,0.39932646970460567,30.0,13.75,18.5,18.0,22.5
2020-05-20 12:48:01,sell,38,82000,82000,84900,1187889,0.0377,1.923957815,-2160,0,82055.0,82060.0,82050.0,82050.0,39,125,0.038016319817825286,-0.04387610657508834,0.39932646970460567,10.0,14.0,18.0,14.0,20.0
2020-05-20 13:53:21,buy,38,81470,81440,78540,1185461,-0.0065,-0.368176762,-2428,0,81415.0,81415.0,81405.0,81410.0,36,80,-0.007800121876904326,-0.04387610657508834,0.39932646970460567,10.0,14.25,18.5,14.0,10.0
2020-05-21 16:57:00,sell,19,83135,81795,84695,1189443,0.0204,1.027607372,3982,1,83135.0,83135.0,83130.0,83130.0,26,87,0.021127625598820785,-0.04387610657508834,0.39932646970460567,5.0,14.25,18.5,14.0,7.5
2020-05-21 17:00:01,sell,19,83085,81795,84695,1193235,-0.0006,-0.064015201,3792,1,83085.0,83100.0,83085.0,83085.0,44,146,-0.0005413208228076507,-0.04387610657508834,0.39932646970460567,15.0,14.5,17.5,14.0,10.0
2020-05-27 16:57:00,sell,19,88015,86610,89510,1197464,0.0593,3.046009604,4229,1,88015.0,88025.0,88015.0,88020.0,98,378,0.059397003069146054,-0.04387610657508834,0.39932646970460567,10.0,14.5,14.0,10.0,12.5
2020-05-27 17:00:01,sell,19,88075,86610,89510,1201921,0.0007,0.002562925,4457,1,88085.0,88090.0,88075.0,88085.0,114,334,0.0007384685298795728,-0.04387610657508834,0.39932646970460567,15.0,14.25,12.5,11.0,12.5
2020-05-29 12:40:09,buy,38,86245,86240,83340,1199703,-0.0208,-1.11090653,-2218,0,86175.0,86180.0,86170.0,86175.0,152,487,-0.02168360106715105,-0.04387610657508834,0.39932646970460567,10.0,13.75,12.5,11.0,12.5
2020-06-10 15:02:06,buy,38,95885,96170,93270,1199669,0.1118,5.766855763,-34,0,95295.0,95295.0,95210.0,95225.0,453,1309,0.10501885697708152,-0.04387610657508834,0.39932646970460567,85.0,17.75,20.5,27.0,47.5
2020-06-22 16:57:00,buy,19,95495,96170,93270,1201134,-0.0041,-0.243852975,1465,1,95490.0,95500.0,95490.0,95495.0,30,130,0.0028353898661065895,-0.04387610657508834,0.39932646970460567,10.0,18.0,20.0,26.0,47.5
2020-06-22 17:00:01,buy,19,95480,96170,93270,1202656,-0.0002,-0.040958883,1522,1,95465.0,95465.0,95455.0,95460.0,121,360,-0.0003665113356720247,-0.04387610657508834,0.39932646970460567,10.0,18.25,18.0,26.0,10.0
2020-06-26 16:57:00,buy,19,93755,94965,92065,1206154,-0.0181,-0.970233459,3498,1,93750.0,93765.0,93750.0,93760.0,24,84,-0.017808506180599204,-0.04387610657508834,0.39932646970460567,15.0,18.25,18.5,26.0,12.5
2020-06-26 17:00:01,buy,19,93770,94965,92065,1209595,0.0002,-0.024507143,3441,1,93765.0,93770.0,93755.0,93765.0,136,618,5.332764505119454e-05,-0.04387610657508834,0.39932646970460567,15.0,18.75,19.0,27.0,15.0
2020-07-01 11:34:10,sell,38,96640,96640,99540,1207455,0.0306,1.555290961,-2140,0,96730.0,96740.0,96730.0,96735.0,149,545,0.03167493201087826,-0.04387610657508834,0.39932646970460567,10.0,19.0,19.5,12.0,12.5
2020-07-01 13:45:13,sell,38,96475,96475,99375,1205235,-0.0017,-0.121399067,-2220,0,96620.0,96620.0,96605.0,96620.0,166,739,-0.0011888148033286814,-0.04387610657508834,0.39932646970460567,15.0,18.5,19.5,13.0,12.5
2020-07-13 10:44:05,sell,38,100670,100675,103575,1202977,0.0435,2.223387927,-2258,0,100805.0,100805.0,100795.0,100795.0,54,172,0.04321051542123784,-0.04387610657508834,0.39932646970460567,10.0,16.75,19.5,13.0,12.5
2020-07-13 15:07:06,sell,38,100590,100590,103490,1200757,-0.0008,-0.074042094,-2220,0,100710.0,100720.0,100710.0,100720.0,112,499,-0.0007440845280023811,-0.04387610657508834,0.39932646970460567,10.0,15.75,19.0,12.0,10.0
2020-07-17 16:57:00,sell,19,103045,101585,104485,1205195,0.0244,1.233549201,4438,1,103045.0,103045.0,103035.0,103040.0,73,264,0.023034154090548053,-0.04387610657508834,0.39932646970460567,10.0,15.75,19.0,11.0,10.0
2020-07-17 17:00:01,sell,19,103050,101585,104485,1209652,0.0,-0.03029095,4457,1,103050.0,103055.0,103045.0,103045.0,86,358,4.852484472049689e-05,-0.04387610657508834,0.39932646970460567,10.0,16.0,11.5,11.0,10.0
2020-07-22 16:52:20,buy,38,104520,104915,102015,1210514,0.0143,0.707357295,862,1,104505.0,104505.0,104500.0,104500.0,44,148,0.01412004464069096,-0.04387610657508834,0.39932646970460567,5.0,15.5,11.0,9.0,7.5
2020-07-23 10:41:13,sell,38,104600,104600,107500,1208294,0.0008,0.00690597,-2220,0,104655.0,104660.0,104645.0,104645.0,63,281,0.0013875598086124403,-0.04387610657508834,0.39932646970460567,15.0,14.75,11.5,10.0,10.0
2020-07-23 12:50:08,buy,38,104410,104385,101485,1205924,-0.0018,-0.127058712,-2370,0,104375.0,104395.0,104370.0,104395.0,844,3130,-0.002389029576186153,-0.04387610657508834,0.39932646970460567,25.0,15.5,12.5,13.0,20.0
2020-07-23 16:57:00,buy,19,102325,103840,100940,1210601,-0.02,-1.068961242,4677,1,102320.0,102325.0,102320.0,102320.0,61,278,-0.019876430863547106,-0.04387610657508834,0.39932646970460567,5.0,15.25,11.5,12.0,15.0
2020-07-23 17:00:01,buy,19,102325,103840,100940,1215278,0.0,-0.032808644,4677,1,102320.0,102340.0,102320.0,102330.0,276,1078,9.773260359655981e-05,-0.04387610657508834,0.39932646970460567,20.0,16.0,12.5,14.0,12.5
2020-07-29 13:38:08,sell,38,104940,104940,107840,1213138,0.0256,1.293210203,-2140,0,105000.0,105005.0,105000.0,105000.0,22,77,0.02609205511580182,-0.04387610657508834,0.39932646970460567,5.0,15.5,11.5,14.0,12.5
2020-07-29 16:57:00,sell,19,105575,104905,107805,1214574,0.0061,0.281164443,1436,1,105575.0,105580.0,105570.0,105570.0,53,189,0.0054285714285714284,-0.04387610657508834,0.39932646970460567,10.0,15.5,11.5,13.0,7.5
2020-07-29 17:00:01,sell,19,105555,104905,107805,1215934,-0.0002,-0.042638081,1360,1,105560.0,105570.0,105555.0,105555.0,135,498,-0.00014208581983518045,-0.04387610657508834,0.39932646970460567,15.0,15.5,12.0,11.0,12.5
2020-07-31 16:57:00,buy,9,103175,104950,102050,1218589,-0.0225,-1.202733326,2655,1,103170.0,103180.0,103165.0,103165.0,61,305,-0.022642224432760174,-0.04387610657508834,0.39932646970460567,15.0,15.75,12.5,13.0,15.0
2020-07-31 17:00:01,buy,9,103325,104950,102050,1220974,0.0015,0.042626989,2385,1,103275.0,103280.0,103250.0,103255.0,953,3841,0.0008723888915814472,-0.04387610657508834,0.39932646970460567,30.0,13.0,14.5,15.0,22.5
2020-08-04 16:57:00,buy,19,101405,102455,99555,1223904,-0.0186,-0.996982989,2930,1,101400.0,101410.0,101400.0,101410.0,43,177,-0.01786838409762239,-0.04387610657508834,0.39932646970460567,10.0,13.0,15.0,16.0,20.0
2020-08-04 17:00:01,buy,19,101425,102455,99555,1226758,0.0002,-0.022574998,2854,1,101435.0,101435.0,101415.0,101420.0,208,716,9.860960457548565e-05,-0.04387610657508834,0.39932646970460567,20.0,13.5,15.5,18.0,15.0
2020-08-07 14:26:02,buy,38,103140,103135,100235,1224540,0.0169,0.844553446,-2218,0,103205.0,103230.0,103200.0,103205.0,821,2495,0.017600078879905345,-0.04387610657508834,0.39932646970460567,30.0,14.25,16.0,21.0,25.0
2020-08-07 16:46:21,buy,38,102755,103150,100250,1225342,-0.0037,-0.226492471,802,1,102705.0,102705.0,102700.0,102705.0,46,175,-0.004844726515188217,-0.04387610657508834,0.39932646970460567,5.0,13.75,16.0,19.0,17.5
2020-08-10 14:05:14,buy,38,102255,102645,99745,1226106,-0.0049,-0.285288537,764,1,102150.0,102165.0,102150.0,102160.0,94,480,-0.005306460250231244,-0.04387610657508834,0.39932646970460567,15.0,14.0,15.5,16.0,10.0
2020-08-24 13:40:08,buy,38,102145,102135,99235,1223830,-0.0011,-0.088625823,-2276,0,102075.0,102080.0,102065.0,102070.0,178,476,-0.0008809710258418168,-0.04387610657508834,0.39932646970460567,15.0,14.0,16.5,17.0,15.0
2020-08-25 16:57:00,buy,19,102045,102525,99625,1224564,-0.001,-0.083606179,734,1,102040.0,102045.0,102040.0,102040.0,38,134,-0.00029391594004114823,-0.04387610657508834,0.39932646970460567,5.0,13.75,16.0,14.0,10.0
2020-08-25 17:00:01,buy,19,102075,102525,99625,1225184,0.0003,-0.017554449,620,1,102070.0,102080.0,102070.0,102070.0,174,527,0.00029400235201881614,-0.04387610657508834,0.39932646970460567,10.0,13.75,15.5,10.0,7.5
2020-08-28 16:57:00,sell,19,102250,101655,104555,1226365,0.0017,0.056148006,1181,1,102250.0,102270.0,102250.0,102260.0,212,939,0.0018614676202606054,-0.04387610657508834,0.39932646970460567,20.0,14.25,16.0,13.0,15.0
2020-08-28 17:00:01,sell,19,102330,101655,104555,1227850,0.0008,0.007787654,1485,1,102325.0,102330.0,102320.0,102325.0,298,1006,0.0006356346567572853,-0.04387610657508834,0.39932646970460567,10.0,14.25,14.0,12.0,15.0
2020-09-03 14:08:07,buy,19,100160,102970,100070,1237428,-0.0212,-1.133122334,9578,1,100470.0,100480.0,100460.0,100465.0,217,702,-0.018177376007818227,-0.04387610657508834,0.39932646970460567,20.0,15.0,15.0,13.0,15.0
2020-09-03 14:44:14,buy,19,100070,102970,100070,1247348,-0.0009,-0.079432474,9920,1,100155.0,100170.0,100155.0,100170.0,54,254,-0.0029363459911411934,-0.04387610657508834,0.39932646970460567,15.0,15.0,14.5,15.0,17.5
2020-09-08 15:17:01,sell,38,100345,100350,103250,1245090,0.0027,0.109781186,-2258,0,100380.0,100380.0,100365.0,100365.0,247,978,0.001946690625935909,-0.04387610657508834,0.39932646970460567,15.0,14.5,13.0,16.0,15.0
2020-09-08 16:10:10,buy,38,100185,100180,97280,1242892,-0.0016,-0.11554264,-2198,0,100145.0,100150.0,100130.0,100130.0,341,1731,-0.0023414536940168386,-0.04387610657508834,0.39932646970460567,20.0,15.25,14.5,16.0,17.5
2020-09-09 13:26:08,buy,38,100955,100935,98035,1240580,0.0077,0.365984589,-2312,0,100910.0,100920.0,100910.0,100915.0,197,688,0.007839808249275942,-0.04387610657508834,0.39932646970460567,10.0,14.75,14.0,16.0,15.0
2020-09-10 16:57:00,buy,19,98775,101130,98230,1248449,-0.0216,-1.15324816,7869,1,98770.0,98780.0,98770.0,98780.0,48,196,-0.021156418768270326,-0.04387610657508834,0.39932646970460567,10.0,15.0,13.5,14.0,10.0
2020-09-10 17:00:01,buy,19,98710,101130,98230,1256565,-0.0007,-0.066953562,8116,1,98715.0,98730.0,98710.0,98725.0,121,478,-0.0005567928730512249,-0.04387610657508834,0.39932646970460567,20.0,15.5,15.0,15.0,15.0
2020-09-16 16:06:00,sell,38,99970,99970,102870,1254345,0.0128,0.629513309,-2220,0,100055.0,100065.0,100055.0,100060.0,127,531,0.013522410736895417,-0.04387610657508834,0.39932646970460567,10.0,15.25,15.0,14.0,15.0
2020-09-17 16:57:00,sell,9,100140,99435,102335,1255074,0.0017,0.05542597,729,1,100140.0,100145.0,100140.0,100140.0,46,212,0.0007995202878273036,-0.04387610657508834,0.39932646970460567,5.0,14.75,13.5,11.0,7.5
2020-09-17 17:00:01,sell,9,100160,99435,102335,1255839,0.0002,-0.022445723,765,1,100155.0,100160.0,100150.0,100160.0,99,313,0.00019972039145196724,-0.04387610657508834,0.39932646970460567,10.0,13.75,13.5,11.0,7.5
2020-09-23 15:17:04,sell,38,96480,96480,99380,1253619,-0.0367,-1.939205265,-2220,0,96580.0,96580.0,96575.0,96575.0,81,332,-0.03579273162939297,-0.04387610657508834,0.39932646970460567,5.0,13.5,12.0,10.0,7.5
2020-09-24 10:38:07,sell,38,96000,96000,98900,1251419,-0.005,-0.290953633,-2200,0,96110.0,96115.0,96105.0,96110.0,148,420,-0.004814910691172664,-0.04387610657508834,0.39932646970460567,10.0,13.0,11.5,8.0,7.5
2020-09-24 15:51:10,sell,38,97080,96710,99610,1252111,0.0113,0.550921713,692,1,97205.0,97205.0,97195.0,97195.0,128,440,0.011289147851420248,-0.04387610657508834,0.39932646970460567,10.0,12.0,11.0,8.0,10.0
2020-09-25 11:27:05,buy,38,96110,96105,93205,1249993,-0.01,-0.551252489,-2118,0,95980.0,95990.0,95970.0,95990.0,362,1025,-0.01239775708626987,-0.04387610657508834,0.39932646970460567,20.0,12.75,11.0,11.0,15.0
2020-09-28 16:57:00,buy,19,94510,96510,93610,1256493,-0.0166,-0.896604591,6500,1,94505.0,94515.0,94505.0,94510.0,53,158,-0.015418272736743411,-0.04387610657508834,0.39932646970460567,10.0,12.5,11.0,11.0,15.0
2020-09-28 17:00:01,buy,19,94600,96510,93610,1262651,0.001,0.016602454,6158,1,94575.0,94590.0,94565.0,94590.0,102,285,0.0008464712728811766,-0.04387610657508834,0.39932646970460567,25.0,13.0,12.5,15.0,17.5
2020-10-01 14:20:15,buy,38,94315,94710,91810,1263493,-0.003,-0.18912826,842,1,94295.0,94315.0,94295.0,94305.0,918,2945,-0.0030130034887408817,-0.04387610657508834,0.39932646970460567,20.0,13.75,12.5,17.0,22.5
2020-10-01 16:57:00,sell,19,95480,94015,96915,1267970,0.0124,0.608112964,4477,1,95480.0,95485.0,95480.0,95480.0,54,277,0.012459572663167382,-0.04387610657508834,0.39932646970460567,5.0,13.5,12.0,16.0,12.5
2020-10-01 17:00:01,sell,19,95555,94015,96915,1272732,0.0008,0.007948957,4762,1,95555.0,95555.0,95515.0,95520.0,648,2191,0.00041893590280687055,-0.04387610657508834,0.39932646970460567,40.0,14.5,15.5,20.0,22.5
2020-10-07 14:44:04,buy,38,95860,95850,92950,1270456,0.0032,0.132808839,-2276,0,95830.0,95835.0,95815.0,95820.0,303,1140,0.00314070351758794,-0.04387610657508834,0.39932646970460567,20.0,15.0,16.5,22.0,30.0
2020-10-08 12:19:10,sell,38,96265,96285,99185,1268084,0.0042,0.186409934,-2372,0,96440.0,96450.0,96435.0,96450.0,167,602,0.006574827802128992,-0.04387610657508834,0.39932646970460567,15.0,14.75,17.5,20.0,17.5
2020-10-13 16:57:00,sell,19,98780,97975,100875,1270083,0.0261,1.322784398,1999,1,98780.0,98780.0,98765.0,98770.0,122,671,0.024053913945049247,-0.04387610657508834,0.39932646970460567,15.0,14.75,18.0,19.0,15.0
2020-10-13 17:00:01,sell,19,98560,97975,100875,1271246,-0.0022,-0.148370209,1163,1,98565.0,98575.0,98560.0,98565.0,189,573,-0.0020755290067834362,-0.04387610657508834,0.39932646970460567,15.0,14.75,18.5,21.0,15.0
2020-10-15 16:57:00,sell,9,99300,98735,101635,1271723,0.0075,0.356766089,477,1,99300.0,99305.0,99295.0,99295.0,89,320,0.007406280119717953,-0.04387610657508834,0.39932646970460567,10.0,14.25,17.5,15.0,12.5
2020-10-15 17:00:01,sell,9,99250,98735,101635,1272110,-0.0005,-0.0589351,387,1,99245.0,99250.0,99235.0,99240.0,217,639,-0.0005539050304647767,-0.04387610657508834,0.39932646970460567,15.0,14.5,18.0,14.0,12.5
2020-10-19 15:01:04,sell,38,99520,99520,102420,1269930,0.0027,0.108345297,-2180,0,99565.0,99565.0,99540.0,99540.0,887,3671,0.003022974607013301,-0.04387610657508834,0.39932646970460567,25.0,15.25,18.0,16.0,20.0
2020-10-19 16:57:00,buy,19,98725,99490,96590,1271737,-0.008,-0.447300992,1807,1,98720.0,98730.0,98715.0,98720.0,143,559,-0.008237894313843681,-0.04387610657508834,0.39932646970460567,15.0,15.0,17.5,16.0,20.0
2020-10-19 17:00:01,buy,19,98830,99490,96590,1273145,0.0011,0.022376467,1408,1,98825.0,98830.0,98815.0,98830.0,200,809,0.001114262560777958,-0.04387610657508834,0.39932646970460567,15.0,15.25,18.5,16.0,15.0
2020-10-22 11:51:07,buy,38,101050,101045,98145,1270907,0.0225,1.132722643,-2238,0,100875.0,100890.0,100875.0,100890.0,143,663,0.020843873317818475,-0.04387610657508834,0.39932646970460567,15.0,15.75,16.0,17.0,15.0
2020-10-22 16:57:00,sell,19,102085,101645,104545,1271469,0.0102,0.498643042,562,1,102085.0,102085.0,102080.0,102080.0,72,254,0.011795024283873525,-0.04387610657508834,0.39932646970460567,5.0,15.5,14.5,15.0,10.0
2020-10-22 17:00:01,sell,19,102095,101645,104545,1272069,0.0001,-0.027725904,600,1,102095.0,102100.0,102085.0,102085.0,241,956,4.898119122257053e-05,-0.04387610657508834,0.39932646970460567,15.0,16.0,14.5,13.0,10.0
2020-10-26 12:05:06,sell,38,101490,101490,104390,1269869,-0.0059,-0.340284244,-2200,0,101510.0,101515.0,101500.0,101500.0,933,3355,-0.005730518685409218,-0.04387610657508834,0.39932646970460567,15.0,16.25,14.5,13.0,15.0
2020-10-26 16:32:08,buy,18,101065,101455,98555,1270193,-0.0042,-0.250091486,324,1,100985.0,100995.0,100980.0,100990.0,294,1144,-0.005024630541871921,-0.04387610657508834,0.39932646970460567,15.0,16.5,14.5,13.0,15.0
2020-10-27 16:57:00,buy,19,99700,101305,98405,1275222,-0.0135,-0.733604665,5029,1,99695.0,99700.0,99695.0,99695.0,12,61,-0.012823051787305674,-0.04387610657508834,0.39932646970460567,5.0,15.75,14.0,11.0,10.0
2020-10-27 17:00:01,buy,19,99635,101305,98405,1280498,-0.0007,-0.066636771,5276,1,99640.0,99680.0,99640.0,99670.0,1290,3729,-0.00025076483273985656,-0.04387610657508834,0.39932646970460567,40.0,17.25,16.5,18.0,22.5
2020-11-12 16:57:00,buy,19,102365,104690,101790,1288233,0.0274,1.38889959,7735,1,102360.0,102370.0,102355.0,102365.0,185,884,0.02703922945720879,-0.04387610657508834,0.39932646970460567,15.0,16.75,15.5,18.0,27.5
2020-11-12 17:00:01,buy,19,102235,104690,101790,1296462,-0.0013,-0.098703516,8229,1,102225.0,102250.0,102220.0,102250.0,217,1009,-0.0011234308601572804,-0.04387610657508834,0.39932646970460567,30.0,17.25,17.0,21.0,22.5
2020-11-18 15:06:10,buy,38,107170,107155,104255,1294148,0.0483,2.471842893,-2314,0,107120.0,107125.0,107115.0,107120.0,74,645,0.04762836185819071,-0.04387610657508834,0.39932646970460567,10.0,17.5,16.5,20.0,20.0
2020-11-19 11:23:04,sell,38,106475,106475,109375,1291928,-0.0065,-0.369297999,-2220,0,106500.0,106505.0,106490.0,106495.0,377,976,-0.005834578043315907,-0.04387610657508834,0.39932646970460567,15.0,16.25,16.5,22.0,12.5
2020-11-19 12:08:05,sell,38,106740,106740,109640,1289708,0.0025,0.096330524,-2220,0,106775.0,106775.0,106765.0,106765.0,33,96,0.0025353302971970514,-0.04387610657508834,0.39932646970460567,10.0,15.75,17.0,16.0,12.5
2020-11-19 15:25:06,buy,38,106345,106740,103840,1290510,-0.0037,-0.224821211,802,1,106225.0,106230.0,106220.0,106225.0,28,104,-0.005057837306233316,-0.04387610657508834,0.39932646970460567,10.0,15.5,16.5,15.0,10.0
2020-11-20 11:48:10,buy,38,106585,106580,103680,1288272,0.0023,0.084290555,-2238,0,106505.0,106515.0,106500.0,106505.0,143,559,0.0026359143327841844,-0.04387610657508834,0.39932646970460567,15.0,15.5,16.5,12.0,12.5
2020-11-20 16:57:00,buy,19,106025,106445,103545,1288798,-0.0053,-0.305424865,526,1,106020.0,106025.0,106015.0,106015.0,32,205,-0.004600722970752547,-0.04387610657508834,0.39932646970460567,10.0,15.25,16.0,12.0,12.5
2020-11-20 17:00:01,buy,19,106045,106445,103545,1289248,0.0002,-0.023020925,450,1,106050.0,106075.0,106050.0,106075.0,456,1273,0.0005659576475027119,-0.04387610657508834,0.39932646970460567,25.0,16.0,18.0,14.0,17.5
2020-11-24 16:57:00,sell,19,109780,108260,111160,1293924,0.0352,1.794703058,4676,1,109780.0,109785.0,109780.0,109780.0,47,200,0.03492811689842093,-0.04387610657508834,0.39932646970460567,5.0,15.5,14.5,13.0,15.0
2020-11-24 17:00:01,sell,19,109760,108260,111160,1298524,-0.0002,-0.042261575,4600,1,109750.0,109755.0,109750.0,109755.0,39,106,-0.0002277281836400073,-0.04387610657508834,0.39932646970460567,5.0,14.5,13.5,12.0,5.0
2020-11-26 16:57:00,sell,19,110140,109605,112505,1299467,0.0035,0.146829788,943,1,110140.0,110150.0,110135.0,110140.0,118,354,0.003507812855906337,-0.04387610657508834,0.39932646970460567,15.0,14.5,12.0,12.0,10.0
2020-11-26 17:00:01,sell,19,110155,109605,112505,1300467,0.0001,-0.025742118,1000,1,110145.0,110150.0,110135.0,110135.0,97,318,-4.539676775013619e-05,-0.04387610657508834,0.39932646970460567,15.0,14.5,12.5,13.0,15.0
2020-11-30 10:56:10,sell,38,110605,110605,113505,1298247,0.0041,0.17915826,-2220,0,110675.0,110680.0,110675.0,110675.0,54,132,0.004903073500703682,-0.04387610657508834,0.39932646970460567,5.0,14.0,11.5,9.0,10.0
2020-11-30 12:55:10,buy,38,109915,109905,107005,1296011,-0.0062,-0.356502225,-2236,0,109820.0,109830.0,109820.0,109820.0,128,502,-0.007725321888412017,-0.04387610657508834,0.39932646970460567,10.0,14.25,11.5,10.0,7.5
2020-11-30 14:32:13,buy,38,109720,109715,106815,1293873,-0.0018,-0.124861529,-2138,0,109605.0,109605.0,109590.0,109595.0,54,220,-0.002048807138954653,-0.04387610657508834,0.39932646970460567,15.0,14.25,12.0,12.0,12.5
2020-12-03 16:57:00,sell,19,113095,112430,115330,1295290,0.0308,1.563245923,1417,1,113095.0,113100.0,113090.0,113095.0,190,595,0.03193576349286008,-0.04387610657508834,0.39932646970460567,10.0,14.0,11.5,11.0,12.5
2020-12-03 17:00:01,sell,19,113080,112430,115330,1296650,-0.0001,-0.039690532,1360,1,113085.0,113090.0,113080.0,113085.0,63,224,-8.842123878155533e-05,-0.04387610657508834,0.39932646970460567,10.0,13.75,11.5,10.0,10.0
2020-12-07 16:57:00,sell,19,114010,113605,116505,1297079,0.0082,0.393925021,429,1,114010.0,114010.0,113995.0,113995.0,115,588,0.008047044258743422,-0.04387610657508834,0.39932646970460567,15.0,14.25,10.5,12.0,12.5
2020-12-07 16:59:06,sell,19,113595,113605,116505,1295931,-0.0036,-0.221679482,-1148,0,113875.0,113875.0,113865.0,113865.0,154,1068,-0.0011404008947760867,-0.04387610657508834,0.39932646970460567,10.0,12.75,11.0,12.0,12.5
2020-12-08 14:25:04,sell,38,113675,113700,116600,1293521,0.0007,0.003733206,-2410,0,113810.0,113810.0,113805.0,113810.0,36,154,-0.0004830281473674966,-0.04387610657508834,0.39932646970460567,5.0,12.25,11.0,10.0,7.5
2020-12-09 16:57:00,buy,19,112780,113895,110995,1296668,-0.0079,-0.441332882,3147,1,112775.0,112780.0,112770.0,112780.0,24,69,-0.009050171338195238,-0.04387610657508834,0.39932646970460567,10.0,11.25,10.5,10.0,7.5
2020-12-09 17:00:01,buy,19,112740,113895,110995,1299967,-0.0004,-0.051211603,3299,1,112720.0,112725.0,112715.0,112720.0,190,493,-0.0005320092214931725,-0.04387610657508834,0.39932646970460567,10.0,11.25,10.0,10.0,10.0
2020-12-14 11:30:05,buy,18,115265,115260,112360,1298869,0.0224,1.129290306,-1098,0,115015.0,115020.0,115000.0,115005.0,468,1719,0.020271469127040455,-0.04387610657508834,0.39932646970460567,20.0,11.5,11.5,11.0,15.0
2020-12-14 14:45:04,sell,38,114960,114965,117865,1296611,-0.0026,-0.170105989,-2258,0,114985.0,115000.0,114985.0,114995.0,168,543,-8.695274118516586e-05,-0.04387610657508834,0.39932646970460567,15.0,11.75,12.0,12.0,17.5
2020-12-15 16:57:00,sell,19,116010,114970,117870,1299463,0.0091,0.441108371,2852,1,116010.0,116010.0,116005.0,116005.0,38,231,0.008782990564807166,-0.04387610657508834,0.39932646970460567,5.0,11.5,11.0,12.0,10.0
2020-12-15 17:00:01,sell,19,116075,114970,117870,1302562,0.0006,-0.003736458,3099,1,116075.0,116085.0,116070.0,116085.0,160,458,0.0006896254471790009,-0.04387610657508834,0.39932646970460567,15.0,11.5,11.5,13.0,10.0
2020-12-18 14:41:07,buy,38,118865,118840,115940,1300172,0.024,1.214360243,-2390,0,118760.0,118760.0,118755.0,118760.0,49,125,0.023043459533962182,-0.04387610657508834,0.39932646970460567,5.0,11.25,11.0,12.0,10.0
2020-12-23 16:57:00,sell,19,118080,117110,120010,1302798,-0.0066,-0.375478118,2626,1,118080.0,118080.0,118065.0,118065.0,91,345,-0.0058521387672617045,-0.04387610657508834,0.39932646970460567,15.0,10.75,11.0,11.0,10.0
2020-12-23 17:00:01,sell,19,118000,117110,120010,1305120,-0.0007,-0.067962534,2322,1,117985.0,117990.0,117980.0,117985.0,63,194,-0.0006775928513954178,-0.04387610657508834,0.39932646970460567,10.0,11.0,11.0,10.0,12.5
2020-12-29 16:57:00,sell,19,119575,119055,121955,1306006,0.0133,0.659752797,886,1,119575.0,119585.0,119575.0,119575.0,98,335,0.013476289358816798,-0.04387610657508834,0.39932646970460567,10.0,11.25,11.5,11.0,10.0
2020-12-29 17:00:01,sell,19,119615,119055,121955,1307044,0.0003,-0.015451456,1038,1,119620.0,119625.0,119610.0,119620.0,103,493,0.00037633284549445955,-0.04387610657508834,0.39932646970460567,15.0,11.25,12.0,11.0,12.5
2021-01-04 16:57:00,buy,9,119010,120415,117515,1309033,-0.0051,-0.295248316,1989,1,119005.0,119015.0,119000.0,119000.0,138,627,-0.0051830797525497406,-0.04387610657508834,0.39932646970460567,15.0,11.25,12.5,13.0,15.0
2021-01-04 17:00:01,buy,9,119025,120415,117515,1310995,0.0001,-0.026268797,1962,1,119020.0,119020.0,119005.0,119015.0,74,336,0.00012605042016806722,-0.04387610657508834,0.39932646970460567,15.0,11.75,12.0,13.0,15.0
2021-01-13 16:03:08,buy,38,122455,122850,119950,1311797,0.0288,1.462447814,802,1,122410.0,122480.0,122405.0,122450.0,2968,13847,0.028861908162836618,-0.04387610657508834,0.39932646970460567,75.0,15.0,18.0,26.0,45.0
2021-01-19 16:57:00,buy,9,120660,121885,118985,1313462,-0.0147,-0.793393523,1665,1,120655.0,120655.0,120645.0,120645.0,72,403,-0.014740710494079216,-0.04387610657508834,0.39932646970460567,10.0,14.75,18.5,26.0,42.5
2021-01-19 17:00:01,buy,9,120590,121885,118985,1315253,-0.0006,-0.062910583,1791,1,120575.0,120595.0,120575.0,120590.0,167,626,-0.00045588296241037753,-0.04387610657508834,0.39932646970460567,20.0,15.25,19.0,27.0,15.0
2021-02-05 11:32:05,sell,38,120170,120170,123070,1313073,-0.0035,-0.213525121,-2180,0,120275.0,120280.0,120250.0,120260.0,918,2667,-0.0027365453188489923,-0.04387610657508834,0.39932646970460567,30.0,16.25,21.5,30.0,25.0
2021-02-05 12:44:08,buy,38,120160,120150,117250,1310797,-0.0001,-0.037126455,-2276,0,120130.0,120130.0,120120.0,120120.0,137,574,-0.0011641443538998836,-0.04387610657508834,0.39932646970460567,10.0,16.0,21.0,29.0,20.0
2021-02-05 16:23:10,sell,38,120600,120610,123510,1308541,0.0037,0.157190881,-2256,0,120665.0,120670.0,120660.0,120660.0,259,856,0.004495504495504496,-0.04387610657508834,0.39932646970460567,10.0,16.0,21.0,16.0,10.0
2021-02-08 10:54:07,buy,38,119750,119725,116825,1306151,-0.007,-0.398514045,-2390,0,119565.0,119590.0,119565.0,119590.0,459,1741,-0.008867893253770926,-0.04387610657508834,0.39932646970460567,25.0,17.0,22.5,19.0,17.5
2021-02-09 11:33:07,buy,38,118775,118760,115860,1303837,-0.0081,-0.455271811,-2314,0,118665.0,118670.0,118650.0,118655.0,412,1793,-0.007818379463165817,-0.04387610657508834,0.39932646970460567,20.0,17.5,23.0,19.0,22.5
2021-02-09 16:57:00,sell,19,119670,118425,121325,1307458,0.0075,0.358174247,3621,1,119670.0,119670.0,119665.0,119665.0,44,228,0.008512072816147655,-0.04387610657508834,0.39932646970460567,5.0,17.25,22.0,14.0,12.5
2021-02-09 17:00:01,sell,19,119725,118425,121325,1311288,0.0005,-0.008961457,3830,1,119720.0,119735.0,119720.0,119735.0,92,542,0.000584966364434045,-0.04387610657508834,0.39932646970460567,15.0,17.0,22.0,15.0,10.0
2021-02-11 14:17:08,sell,38,119230,119230,122130,1309068,-0.0041,-0.24733473,-2220,0,119360.0,119360.0,119340.0,119350.0,727,2810,-0.003215434083601286,-0.04387610657508834,0.39932646970460567,20.0,17.25,16.5,17.0,17.5
2021-02-12 15:00:09,sell,38,119395,119405,122305,1306772,0.0014,0.03899693,-2296,0,119520.0,119530.0,119520.0,119520.0,185,570,0.0014243820695433599,-0.04387610657508834,0.39932646970460567,10.0,17.5,16.5,14.0,15.0
2021-02-17 16:57:00,sell,19,120555,119495,122395,1309730,0.0097,0.471308662,2958,1,120555.0,120555.0,120550.0,120550.0,99,377,0.008617804551539491,-0.04387610657508834,0.39932646970460567,5.0,17.0,15.0,11.0,7.5
2021-02-17 17:00:01,sell,19,120505,119495,122395,1312498,-0.0004,-0.054328756,2768,1,120500.0,120505.0,120495.0,120495.0,92,267,-0.0004562422231439237,-0.04387610657508834,0.39932646970460567,10.0,17.25,13.0,12.0,7.5
2021-02-25 15:03:04,buy,19,113700,116515,113615,1322095,-0.0565,-2.962911186,9597,1,113810.0,113815.0,113785.0,113810.0,385,1342,-0.05547948047636832,-0.04387610657508834,0.39932646970460567,30.0,18.0,15.0,15.0,20.0
2021-02-25 15:04:08,buy,19,113620,116515,113615,1331996,-0.0007,-0.069316748,9901,1,113705.0,113705.0,113680.0,113680.0,208,707,-0.0011422546349178456,-0.04387610657508834,0.39932646970460567,25.0,18.75,16.5,16.0,27.5
2021-02-25 15:19:14,buy,38,113940,113915,111015,1329606,0.0028,0.113326594,-2390,0,113835.0,113840.0,113820.0,113820.0,190,777,0.0012315270935960591,-0.04387610657508834,0.39932646970460567,20.0,19.25,16.0,18.0,22.5
2021-02-25 16:15:04,buy,38,113845,113840,110940,1327388,-0.0008,-0.076070699,-2218,0,113805.0,113820.0,113805.0,113820.0,153,586,0.0,-0.04387610657508834,0.39932646970460567,15.0,19.25,15.5,20.0,17.5
2021-03-15 12:38:07,sell,38,114055,114065,116965,1325112,0.0018,0.06290307,-2276,0,114215.0,114220.0,114210.0,114210.0,137,560,0.003426462836056932,-0.04387610657508834,0.39932646970460567,10.0,19.0,16.0,20.0,12.5
2021-03-15 16:43:01,sell,38,114545,114555,117455,1322816,0.0043,0.190107493,-2296,0,114550.0,114630.0,114535.0,114600.0,2641,10248,0.003414762280010507,-0.04387610657508834,0.39932646970460567,95.0,23.0,24.0,33.0,52.5
2021-03-16 16:25:21,buy,38,114055,114045,111145,1320560,-0.0043,-0.254771191,-2256,0,114035.0,114040.0,114020.0,114020.0,464,1466,-0.00506108202443281,-0.04387610657508834,0.39932646970460567,20.0,20.25,24.0,32.0,57.5
2021-03-17 15:49:08,sell,19,116315,113510,116410,1330129,0.0198,0.995335171,9569,1,116160.0,116165.0,116155.0,116160.0,72,231,0.01876863708121382,-0.04387610657508834,0.39932646970460567,10.0,20.25,24.0,30.0,15.0
2021-03-17 15:52:13,sell,19,116410,113510,116410,1340059,0.0008,0.009570057,9930,1,116300.0,116315.0,116300.0,116310.0,121,411,0.0012913223140495868,-0.04387610657508834,0.39932646970460567,15.0,20.0,25.0,30.0,12.5
2021-03-17 16:57:00,sell,19,116580,116115,119015,1340736,0.0015,0.042965038,677,1,116580.0,116580.0,116570.0,116575.0,62,192,0.0022783939472100423,-0.04387610657508834,0.39932646970460567,10.0,19.0,25.0,30.0,12.5
2021-03-17 17:00:01,sell,19,116660,116115,119015,1341717,0.0007,0.002797562,981,1,116670.0,116675.0,116660.0,116660.0,229,878,0.000729144327686039,-0.04387610657508834,0.39932646970460567,15.0,19.25,23.5,14.0,12.5
2021-03-22 11:26:14,buy,38,114490,114475,111575,1339403,-0.0186,-0.997964652,-2314,0,114405.0,114415.0,114400.0,114415.0,104,396,-0.019243956797531287,-0.04387610657508834,0.39932646970460567,15.0,19.5,22.5,13.0,15.0
2021-03-30 16:57:00,sell,19,116830,115790,118690,1342255,0.0204,1.027684973,2852,1,116830.0,116835.0,116825.0,116825.0,41,142,0.021063671721365206,-0.04387610657508834,0.39932646970460567,10.0,18.75,21.5,13.0,12.5
2021-03-30 17:00:01,sell,19,116910,115790,118690,1345411,0.0007,0.002721369,3156,1,116915.0,116935.0,116915.0,116925.0,321,1064,0.0008559811684142949,-0.04387610657508834,0.39932646970460567,20.0,18.75,22.0,14.0,15.0
2021-04-01 16:57:00,buy,19,115245,117025,114125,1351075,-0.0142,-0.771771032,5664,1,115240.0,115250.0,115240.0,115245.0,68,217,-0.01436818473380372,-0.04387610657508834,0.39932646970460567,10.0,19.0,22.0,14.0,15.0
2021-04-01 17:00:01,buy,19,115135,117025,114125,1357157,-0.001,-0.082334312,6082,1,115165.0,115180.0,115160.0,115175.0,509,1649,-0.000607401622630049,-0.04387610657508834,0.39932646970460567,20.0,19.25,14.5,15.0,15.0
2021-04-07 13:45:10,buy,38,117485,117880,114980,1357979,0.0204,1.026250597,822,1,117425.0,117435.0,117420.0,117430.0,219,851,0.019578901671369654,-0.04387610657508834,0.39932646970460567,15.0,19.0,14.0,15.0,17.5
2021-04-07 15:55:06,sell,38,117585,117185,120085,1358839,0.0009,0.011356265,860,1,117865.0,117865.0,117855.0,117855.0,52,156,0.0036191773822702887,-0.04387610657508834,0.39932646970460567,10.0,19.0,14.0,15.0,12.5
2021-04-08 10:40:06,buy,38,117945,117940,115040,1356621,0.0031,0.126049811,-2218,0,117870.0,117870.0,117860.0,117865.0,214,725,8.485002757625896e-05,-0.04387610657508834,0.39932646970460567,10.0,19.25,13.5,13.0,10.0
2021-04-08 16:57:00,sell,19,118400,117935,120835,1357278,0.0039,0.167357959,657,1,118400.0,118400.0,118395.0,118400.0,7,16,0.004539091333305052,-0.04387610657508834,0.39932646970460567,5.0,19.0,13.0,12.0,7.5
2021-04-08 17:00:01,sell,19,118360,117935,120835,1357783,-0.0003,-0.050338084,505,1,118355.0,118355.0,118335.0,118335.0,637,2225,-0.0005489864864864865,-0.04387610657508834,0.39932646970460567,20.0,18.5,13.5,12.0,12.5
2021-04-12 15:40:06,sell,38,118460,118470,121370,1355507,0.0008,0.011029767,-2276,0,118570.0,118580.0,118570.0,118575.0,377,1476,0.0020281404487260744,-0.04387610657508834,0.39932646970460567,10.0,17.75,13.0,11.0,15.0
2021-04-13 10:51:06,buy,38,118405,118400,115500,1353269,-0.0005,-0.056899416,-2238,0,118350.0,118360.0,118350.0,118360.0,86,276,-0.0018131983976386254,-0.04387610657508834,0.39932646970460567,10.0,17.25,13.0,11.0,10.0
2021-04-13 16:57:00,sell,19,119150,118740,121640,1353737,0.0063,0.293663392,468,1,119150.0,119150.0,119145.0,119145.0,77,285,0.006632308212233862,-0.04387610657508834,0.39932646970460567,5.0,16.75,11.5,10.0,7.5
2021-04-13 17:00:01,sell,19,119135,118740,121640,1354148,-0.0001,-0.039340806,411,1,119140.0,119145.0,119135.0,119140.0,143,486,-4.196567208023837e-05,-0.04387610657508834,0.39932646970460567,10.0,16.75,11.5,11.0,7.5
2021-04-16 10:53:08,sell,38,120905,120910,123810,1351930,0.0149,0.738083561,-2218,0,120965.0,120970.0,120960.0,120970.0,157,840,0.015360080577471881,-0.04387610657508834,0.39932646970460567,10.0,12.5,10.5,9.0,10.0
2021-04-16 16:57:00,sell,19,121430,120730,123630,1353490,0.0043,0.192498416,1560,1,121430.0,121435.0,121420.0,121420.0,153,828,0.003719930561296189,-0.04387610657508834,0.39932646970460567,15.0,12.25,10.5,10.0,12.5
2021-04-16 17:00:01,sell,19,121500,120730,123630,1355316,0.0006,-0.002897584,1826,1,121485.0,121500.0,121485.0,121495.0,111,444,0.000617690660517213,-0.04387610657508834,0.39932646970460567,15.0,12.5,11.0,11.0,15.0
2021-04-20 12:58:14,buy,38,120855,120835,117935,1353004,-0.0053,-0.308258908,-2312,0,120750.0,120755.0,120740.0,120745.0,154,760,-0.006173093542944154,-0.04387610657508834,0.39932646970460567,15.0,12.5,11.5,13.0,15.0
2021-04-20 14:44:14,buy,38,120635,120630,117730,1350806,-0.0018,-0.127262091,-2198,0,120610.0,120615.0,120600.0,120610.0,282,1339,-0.0011180587187875274,-0.04387610657508834,0.39932646970460567,15.0,12.75,12.5,14.0,15.0
2021-04-22 11:20:01,buy,38,120600,120585,117685,1348492,-0.0003,-0.047862732,-2314,0,120555.0,120560.0,120545.0,120545.0,475,1726,-0.0005389271204709393,-0.04387610657508834,0.39932646970460567,15.0,12.75,12.0,15.0,15.0
2021-04-22 13:37:08,sell,38,120635,120650,123550,1346198,0.0003,-0.017750186,-2294,0,120780.0,120780.0,120770.0,120770.0,79,275,0.0018665228752747936,-0.04387610657508834,0.39932646970460567,10.0,12.5,12.0,14.0,12.5
2021-04-22 15:26:08,buy,38,120300,120280,117380,1343846,-0.0028,-0.176897779,-2352,0,120205.0,120205.0,120195.0,120200.0,49,142,-0.00471971516104993,-0.04387610657508834,0.39932646970460567,10.0,12.5,12.0,13.0,10.0
2021-04-23 11:01:08,sell,38,120820,120835,123735,1341592,0.0043,0.191474933,-2254,0,120915.0,120915.0,120910.0,120910.0,226,650,0.005906821963394343,-0.04387610657508834,0.39932646970460567,5.0,11.75,12.0,11.0,7.5
2021-04-23 14:57:21,sell,38,120640,120645,123545,1339334,-0.0015,-0.110111124,-2258,0,120650.0,120655.0,120650.0,120650.0,88,246,-0.0021503597717310394,-0.04387610657508834,0.39932646970460567,5.0,11.5,11.5,9.0,5.0
2021-04-26 16:57:00,buy,19,120965,121115,118215,1338804,0.0027,0.10697353,-530,0,120960.0,120970.0,120960.0,120960.0,126,389,0.00256941566514712,-0.04387610657508834,0.39932646970460567,10.0,11.0,11.5,8.0,7.5
2021-04-26 17:00:01,buy,19,121060,121115,118215,1337913,0.0008,0.007940983,-891,0,121040.0,121055.0,121035.0,121045.0,243,978,0.0007027116402116402,-0.04387610657508834,0.39932646970460567,20.0,11.25,12.0,10.0,15.0
2021-04-28 16:57:00,sell,19,121460,121255,124155,1337582,0.0033,0.138634088,-331,0,121460.0,121470.0,121460.0,121465.0,100,600,0.003469783964641249,-0.04387610657508834,0.39932646970460567,10.0,11.25,11.5,10.0,15.0
2021-04-28 17:00:01,sell,19,121425,121255,124155,1337118,-0.0003,-0.04776048,-464,0,121420.0,121425.0,121415.0,121415.0,162,549,-0.00041164121351829747,-0.04387610657508834,0.39932646970460567,10.0,11.25,11.0,11.0,10.0
2021-04-30 14:52:10,sell,38,119795,119800,122700,1334880,-0.0134,-0.729337717,-2238,0,119820.0,119820.0,119810.0,119810.0,155,504,-0.01321912449038422,-0.04387610657508834,0.39932646970460567,10.0,11.5,10.5,12.0,10.0
2021-05-03 15:47:08,buy,38,119645,120030,117130,1335646,-0.0013,-0.097778562,766,1,119585.0,119585.0,119575.0,119575.0,244,856,-0.0019614389449962443,-0.04387610657508834,0.39932646970460567,10.0,11.0,10.0,12.0,10.0
2021-05-04 13:13:01,buy,38,119005,118995,116095,1333450,-0.0053,-0.310361165,-2196,0,118965.0,118980.0,118965.0,118975.0,799,2677,-0.005017771273259461,-0.04387610657508834,0.39932646970460567,15.0,11.25,10.5,11.0,12.5
2021-05-05 16:57:00,sell,9,120070,118990,121890,1334854,0.0089,0.431539973,1404,1,120070.0,120070.0,120065.0,120065.0,81,271,0.009161588569027107,-0.04387610657508834,0.39932646970460567,5.0,11.0,10.0,10.0,10.0
2021-05-05 17:00:01,sell,9,120055,118990,121890,1336231,-0.0001,-0.039290755,1377,1,120045.0,120050.0,120040.0,120045.0,110,494,-0.00016657643776287845,-0.04387610657508834,0.39932646970460567,10.0,11.25,10.5,10.0,7.5
2021-05-07 16:57:00,sell,19,122265,120965,123865,1340061,0.0184,0.922341793,3830,1,122265.0,122275.0,122265.0,122275.0,131,564,0.01857636719563497,-0.04387610657508834,0.39932646970460567,10.0,11.25,11.0,10.0,10.0
2021-05-07 17:00:01,sell,19,122385,120965,123865,1344347,0.001,0.018117273,4286,1,122365.0,122370.0,122350.0,122355.0,414,1658,0.0006542629319157636,-0.04387610657508834,0.39932646970460567,20.0,11.75,12.0,12.0,15.0
2021-05-11 16:57:00,sell,19,123065,121590,124490,1348842,0.0056,0.255488592,4495,1,123065.0,123065.0,123055.0,123060.0,142,688,0.005761922275346328,-0.04387610657508834,0.39932646970460567,10.0,11.5,11.0,11.0,15.0
2021-05-11 17:00:01,sell,19,123090,121590,124490,1353432,0.0002,-0.022268047,4590,1,123085.0,123095.0,123085.0,123085.0,208,711,0.00020315293352836015,-0.04387610657508834,0.39932646970460567,10.0,11.25,11.0,12.0,10.0
2021-05-17 12:10:14,sell,38,122370,122370,125270,1351252,-0.0058,-0.336316181,-2180,0,122435.0,122445.0,122435.0,122445.0,139,504,-0.005199658772393062,-0.04387610657508834,0.39932646970460567,10.0,11.0,11.0,12.0,10.0
2021-05-17 16:57:00,sell,19,123140,122185,125085,1353771,0.0063,0.293685595,2519,1,123140.0,123140.0,123135.0,123140.0,30,98,0.005676017803911961,-0.04387610657508834,0.39932646970460567,5.0,10.5,10.5,11.0,7.5
2021-05-17 17:00:01,sell,19,123200,122185,125085,1356518,0.0005,-0.007526618,2747,1,123185.0,123190.0,123185.0,123185.0,117,474,0.00036543771317199935,-0.04387610657508834,0.39932646970460567,5.0,10.0,10.0,8.0,5.0
2021-05-19 15:11:05,sell,38,122320,121945,124845,1357148,-0.0071,-0.403431092,630,1,122625.0,122630.0,122610.0,122610.0,303,1161,-0.004667776109104193,-0.04387610657508834,0.39932646970460567,20.0,10.5,10.5,10.0,12.5
2021-05-19 15:23:03,buy,38,122725,122720,119820,1354950,0.0033,0.138989042,-2198,0,122730.0,122740.0,122720.0,122725.0,204,747,0.0009379332843976837,-0.04387610657508834,0.39932646970460567,20.0,11.0,12.0,12.0,20.0
2021-05-20 12:07:10,sell,38,122665,122665,125565,1352730,-0.0005,-0.058176161,-2220,0,122700.0,122705.0,122695.0,122700.0,85,311,-0.00020370747606437156,-0.04387610657508834,0.39932646970460567,10.0,11.25,12.0,12.0,15.0
2021-05-20 16:57:00,sell,19,122835,122330,125230,1353539,0.0014,0.039101146,809,1,122835.0,122840.0,122830.0,122830.0,68,221,0.0010594947025264873,-0.04387610657508834,0.39932646970460567,10.0,11.5,12.0,13.0,10.0
2021-05-20 17:00:01,sell,19,122875,122330,125230,1354500,0.0003,-0.01591211,961,1,122855.0,122860.0,122850.0,122855.0,175,749,0.00020353333876088904,-0.04387610657508834,0.39932646970460567,10.0,11.5,11.0,14.0,10.0
2021-05-24 11:08:14,sell,38,123485,123490,126390,1352242,0.005,0.224779614,-2258,0,123530.0,123540.0,123530.0,123540.0,189,673,0.005575678645557771,-0.04387610657508834,0.39932646970460567,10.0,11.0,11.0,12.0,10.0
2021-05-24 16:57:00,sell,19,124285,123245,126145,1355094,0.0065,0.303343231,2852,1,124285.0,124285.0,124280.0,124280.0,39,113,0.005989962765096325,-0.04387610657508834,0.39932646970460567,5.0,10.75,10.5,9.0,7.5
2021-05-24 17:00:01,sell,19,124250,123245,126145,1357813,-0.0003,-0.047420624,2719,1,124255.0,124260.0,124245.0,124255.0,158,771,-0.00020115867396202123,-0.04387610657508834,0.39932646970460567,15.0,11.0,11.0,10.0,10.0
2021-05-26 13:41:01,sell,38,124015,124020,126920,1355555,-0.0019,-0.130945292,-2258,0,124025.0,124045.0,124025.0,124040.0,731,3863,-0.0017303126634743069,-0.04387610657508834,0.39932646970460567,20.0,11.5,12.5,12.0,17.5
2021-05-27 11:13:08,sell,38,124355,124355,127255,1353335,0.0027,0.109445346,-2220,0,124430.0,124430.0,124420.0,124420.0,209,982,0.0030635278942276684,-0.04387610657508834,0.39932646970460567,10.0,11.5,13.0,12.0,15.0
2021-05-27 14:47:09,buy,38,124240,124235,121335,1351117,-0.0009,-0.080792411,-2218,0,124225.0,124230.0,124220.0,124220.0,119,544,-0.0016074586079408454,-0.04387610657508834,0.39932646970460567,10.0,11.25,12.0,12.0,10.0
2021-05-28 11:18:10,sell,38,124665,124665,127565,1348937,0.0034,0.144686814,-2180,0,124705.0,124705.0,124700.0,124705.0,101,476,0.0039043632265335694,-0.04387610657508834,0.39932646970460567,5.0,11.25,10.5,12.0,7.5
2021-05-28 16:57:00,sell,19,125695,125165,128065,1349861,0.0083,0.395890326,924,1,125695.0,125695.0,125690.0,125695.0,57,197,0.00793873541558077,-0.04387610657508834,0.39932646970460567,5.0,11.0,10.0,10.0,5.0
2021-05-28 17:00:01,sell,19,125675,125165,128065,1350709,-0.0002,-0.041064683,848,1,125685.0,125700.0,125685.0,125690.0,190,601,-3.9778829706830026e-05,-0.04387610657508834,0.39932646970460567,15.0,11.25,10.5,9.0,10.0
2021-06-04 12:18:14,buy,38,129550,129530,126630,1348377,0.0308,1.567053528,-2332,0,129530.0,129540.0,129530.0,129540.0,206,741,0.030630917336303604,-0.04387610657508834,0.39932646970460567,10.0,10.75,10.5,9.0,12.5
2021-06-04 14:28:16,buy,38,129750,129745,126845,1346139,0.0015,0.047295012,-2238,0,129690.0,129690.0,129685.0,129690.0,12,31,0.001157943492357573,-0.04387610657508834,0.39932646970460567,5.0,10.5,10.0,8.0,7.5
2021-06-07 16:57:00,sell,19,130760,129780,132680,1348753,0.0078,0.371091274,2614,1,130760.0,130765.0,130755.0,130760.0,82,382,0.008250443364947182,-0.04387610657508834,0.39932646970460567,10.0,10.5,10.5,9.0,7.5
2021-06-07 17:00:01,sell,19,130820,129780,132680,1351595,0.0005,-0.008999921,2842,1,130815.0,130825.0,130815.0,130825.0,93,447,0.0004970939125114714,-0.04387610657508834,0.39932646970460567,10.0,10.5,10.0,10.0,10.0
2021-06-09 11:15:00,sell,38,129930,129950,132850,1349243,-0.0068,-0.385809386,-2352,0,129980.0,129980.0,129950.0,129955.0,1901,6737,-0.006650105102235811,-0.04387610657508834,0.39932646970460567,30.0,11.75,11.0,13.0,20.0
2021-06-09 15:13:10,sell,38,130270,130285,133185,1346909,0.0026,0.102969303,-2334,0,130295.0,130295.0,130285.0,130285.0,203,1065,0.002539340540956485,-0.04387610657508834,0.39932646970460567,10.0,12.0,11.0,13.0,20.0
2021-06-09 16:57:00,buy,19,129875,130355,127455,1347633,-0.003,-0.190138968,724,1,129870.0,129870.0,129830.0,129835.0,1723,7937,-0.0034539663046398283,-0.04387610657508834,0.39932646970460567,40.0,13.0,14.0,20.0,25.0
2021-06-09 17:00:01,buy,19,129935,130355,127455,1348129,0.0005,-0.008837682,496,1,129935.0,129950.0,129935.0,129945.0,385,2199,0.0008472291754919706,-0.04387610657508834,0.39932646970460567,15.0,12.75,15.0,21.0,27.5
2021-06-11 16:57:00,buy,19,129350,129530,126630,1347713,-0.0045,-0.266417591,-416,0,129345.0,129350.0,129345.0,129345.0,58,312,-0.004617338104582708,-0.04387610657508834,0.39932646970460567,5.0,12.5,15.0,20.0,10.0
2021-06-11 17:00:01,buy,19,129390,129530,126630,1347145,0.0003,-0.016763141,-568,0,129385.0,129385.0,129365.0,129365.0,207,607,0.00015462522710580232,-0.04387610657508834,0.39932646970460567,20.0,13.0,15.5,18.0,12.5
2021-06-15 13:13:08,buy,38,129655,129645,126745,1344869,0.002,0.073459946,-2276,0,129605.0,129620.0,129605.0,129610.0,1161,3982,0.0018938661925559464,-0.04387610657508834,0.39932646970460567,15.0,13.25,16.0,19.0,17.5
2021-06-15 16:57:00,sell,19,130060,129560,132460,1345679,0.0031,0.129269894,810,1,130060.0,130060.0,130055.0,130060.0,9,13,0.0034719543245119973,-0.04387610657508834,0.39932646970460567,5.0,13.0,16.0,12.0,10.0
2021-06-15 17:00:01,sell,19,130110,129560,132460,1346679,0.0004,-0.012861257,1000,1,130115.0,130125.0,130115.0,130125.0,184,725,0.0004997693372289713,-0.04387610657508834,0.39932646970460567,10.0,13.25,16.0,11.0,7.5
2021-06-17 11:49:59,sell,38,130175,130180,133080,1344421,0.0005,-0.006887006,-2258,0,130190.0,130190.0,130175.0,130175.0,342,1378,0.00038424591738712776,-0.04387610657508834,0.39932646970460567,15.0,13.25,16.5,13.0,12.5
2021-06-17 16:57:00,buy,19,128685,129405,126505,1346087,-0.0114,-0.626715636,1666,1,128680.0,128690.0,128680.0,128690.0,56,335,-0.011407720376416363,-0.04387610657508834,0.39932646970460567,10.0,12.75,14.5,11.0,12.5
2021-06-17 17:00:01,buy,19,128680,129405,126505,1347772,0.0,-0.034824696,1685,1,128675.0,128685.0,128665.0,128680.0,165,811,-7.770611547128759e-05,-0.04387610657508834,0.39932646970460567,20.0,13.25,15.5,12.0,15.0
2021-06-21 13:50:08,sell,38,129450,129460,132360,1345476,0.006,0.277675503,-2296,0,129480.0,129490.0,129475.0,129485.0,753,2983,0.0062558284115635686,-0.04387610657508834,0.39932646970460567,15.0,13.5,13.0,14.0,17.5
2021-06-22 12:29:21,buy,38,129170,129165,126265,1343238,-0.0022,-0.145040393,-2238,0,129135.0,129135.0,129130.0,129130.0,31,219,-0.0027416303046684945,-0.04387610657508834,0.39932646970460567,5.0,13.5,12.0,13.0,10.0
2021-06-23 13:34:13,sell,38,129825,129825,132725,1341018,0.0051,0.230302594,-2220,0,129835.0,129845.0,129835.0,129835.0,135,602,0.0054596143421358325,-0.04387610657508834,0.39932646970460567,10.0,13.75,12.5,12.0,7.5
2021-06-23 14:31:14,buy,38,129450,129435,126535,1338744,-0.0029,-0.18268485,-2274,0,129350.0,129350.0,129345.0,129350.0,34,202,-0.003735510455578234,-0.04387610657508834,0.39932646970460567,5.0,13.25,11.0,11.0,7.5
2021-06-24 16:45:16,buy,38,130130,130115,127215,1336430,0.0053,0.239754177,-2314,0,130080.0,130085.0,130075.0,130085.0,43,271,0.005682257441051411,-0.04387610657508834,0.39932646970460567,10.0,13.25,10.5,9.0,7.5
2021-06-25 16:57:00,buy,19,127720,129590,126690,1342446,-0.0185,-0.993755498,6016,1,127715.0,127725.0,127715.0,127725.0,56,173,-0.018141984087327517,-0.04387610657508834,0.39932646970460567,10.0,13.5,11.0,8.0,10.0
2021-06-25 17:00:01,buy,19,127945,129590,126690,1347607,0.0018,0.058599179,5161,1,127940.0,127950.0,127940.0,127950.0,235,1081,0.0017615971814445098,-0.04387610657508834,0.39932646970460567,10.0,13.5,11.0,9.0,10.0
2021-06-30 14:32:10,sell,38,127170,127175,130075,1345389,-0.0061,-0.347104127,-2218,0,127200.0,127205.0,127180.0,127185.0,989,4109,-0.005978898007033997,-0.04387610657508834,0.39932646970460567,25.0,14.25,12.0,12.0,17.5
